Receipt No.,Completion Time,Details,Transaction Status,Paid In,Withdrawn,Balance
TF33DL9L4P,2025-06-03 17:53:00.010,Merchant Payment Online to 6900165 -             ALONG MAGOK MAJOK DHOR,Completed,,-320.0,3903.76
TF39C7J3F3,2025-06-03 12:58:59.981,Customer Transfer to - 01******452 NAncy okoth,Completed,,-100.0,4223.76
TF38C4RRTE,2025-06-03 12:40:59.981,Customer Transfer of Funds Charge,Completed,,-13.0,4323.76
TF38C4RRTE,2025-06-03 12:40:59.981,Customer Transfer to - 01******452 NAncy okoth,Completed,,-600.0,4336.76
TF2693E27Q,2025-06-02 18:29:00.010,Customer Transfer of Funds Charge,Completed,,-13.0,4936.76
TF2693E27Q,2025-06-02 18:29:00.010,Customer Transfer to - 01******452 NAncy okoth,Completed,,-700.0,4949.76
TEV8ZPPKO4,2025-05-31 20:21:59.990,Customer Transfer of Funds Charge,Completed,,-7.0,5649.76
TEV8ZPPKO4,2025-05-31 20:21:59.990,Customer Transfer to - 07******576 WARUGURU IDDA,Completed,,-500.0,5656.76
TEV3ZPFRDN,2025-05-31 20:21:00.029,Pay Bill Charge,Completed,,-42.0,6156.76
TEV3ZPFRDN,2025-05-31 20:21:00.029,Pay Bill Online to 247247 - Equity Paybill Account Acc. 0510173643067,Completed,,-6000.0,6198.76
TEV2ZP37LQ,2025-05-31 20:19:59.981,Pay Bill Charge,Completed,,-18.0,12198.76
TEV2ZP37LQ,2025-05-31 20:19:59.981,Pay Bill Online to 505000 - OLD MUTUAL LIFE ASSURANCE KENYA LIMITED. Acc. OMU000329285,Completed,,-15000.0,12216.76
TEV5ZOYWVT,2025-05-31 20:19:00.019,Pay Bill Charge,Completed,,-34.0,27216.76
TEV5ZOYWVT,2025-05-31 20:19:00.019,Pay Bill Online to 850436 - HAZINA SACCO LTD Acc. 37325314DEP,Completed,,-5000.0,27250.76
TEV8ZOU1MG,2025-05-31 20:19:00.019,Customer Transfer of Funds Charge,Completed,,-23.0,32250.76
TEV8ZOU1MG,2025-05-31 20:19:00.019,Customer Transfer to - 07******576 WARUGURU IDDA,Completed,,-1100.0,32273.76
TEV2ZOBL38,2025-05-31 20:15:59.962,Pay Bill Charge,Completed,,-34.0,33373.76
TEV2ZOBL38,2025-05-31 20:15:59.962,Pay Bill Online to 850436 - HAZINA SACCO LTD Acc. 33826744DEP,Completed,,-5000.0,33407.76
TEV2YWW1DA,2025-05-31 18:33:00.029,Merchant Payment Online to 7188373 - PURE FRESH RONGAI STIMVAK,Completed,,-250.0,38407.76
TEV9YPRF5D,2025-05-31 18:02:00.010,Customer Transfer of Funds Charge,Completed,,-7.0,38657.76
TEV9YPRF5D,2025-05-31 18:02:00.010,Customer Transfer to - 2547******267 PETER MUCHAI,Completed,,-200.0,38664.76
TEV1YISWF9,2025-05-31 17:28:59.981,,Completed,40742.0,,40742.0
TEV0YISX20,2025-05-31 17:28:59.981,,Completed,,-1877.24,38864.76
TEV0YBIOE4,2025-05-31 16:52:00.019,,Completed,,-3639.0,0.0
TEV0YBIOE4,2025-05-31 16:52:00.019,of Credit Party,Completed,1858.65,,3639.0
TEV9YBDP79,2025-05-31 16:50:59.971,,Completed,846.0,,1780.35
TET4NA78BK,2025-05-29 11:35:59.971,,Completed,,-753.0,934.35
TET0N9Y0ZE,2025-05-29 11:35:00.010,,Completed,1500.0,,1687.35
TES3K69ED1,2025-05-28 17:35:59.971,,Completed,,-7.0,187.35
TES3K69ED1,2025-05-28 17:35:59.971,,Completed,,-400.0,194.35
TER3FFVE9T,2025-05-27 17:08:59.971,,Completed,,-13.0,594.35
TER3FFVE9T,2025-05-27 17:08:59.971,,Completed,,-1000.0,607.35
TER2F1L3SY,2025-05-27 15:42:59.990,,Completed,,-892.65,1607.35
TER5F1KSPB,2025-05-27 15:42:59.990,,Completed,2500.0,,2500.0
TER1EEWMTZ,2025-05-27 13:14:59.971,,Completed,,-13.0,0.0
TER1EEWMTZ,2025-05-27 13:14:59.971,,Completed,,-750.0,13.0
TER1EEWMTZ,2025-05-27 13:14:59.971,of Credit Party,Completed,763.0,,763.0
TEQ3CJDWD9,2025-05-26 22:03:59.962,,Completed,,-7.0,0.0
TEQ3CJDWD9,2025-05-26 22:03:59.962,,Completed,,-150.0,7.0
TEQ3CJDWD9,2025-05-26 22:03:59.962,of Credit Party,Completed,120.81,,157.0
TEQ0CE1XL4,2025-05-26 21:22:59.981,,Completed,,-250.0,36.19
TEQ79W5KW9,2025-05-26 13:41:00.010,,Completed,,-7.0,286.19
TEQ79W5KW9,2025-05-26 13:41:00.010,,Completed,,-500.0,293.19
TEQ99W28HL,2025-05-26 13:39:59.962,,Completed,,-5.0,793.19
TEQ29VXC5M,2025-05-26 13:39:00.000,,Completed,,-4000.0,798.19
TEQ79FXSXT,2025-05-26 11:55:00.019,,Completed,,-1000.0,4798.19
TEQ09FT0KW,2025-05-26 11:53:59.971,,Completed,,-201.81,5798.19
TEQ99FTD4J,2025-05-26 11:53:59.971,,Completed,6000.0,,6000.0
TEN3WQOQCD,2025-05-23 18:53:00.038,,Completed,,-7.0,0.0
TEN3WQOQCD,2025-05-23 18:53:00.038,,Completed,,-280.0,7.0
TEN3WQOQCD,2025-05-23 18:53:00.038,of Credit Party,Completed,199.81,,287.0
TEM9QEAS8D,2025-05-22 12:42:59.990,,Completed,,-62.0,87.19
TEM9QEAS8D,2025-05-22 12:42:59.990,,Completed,,-19000.0,149.19
TEM4Q2HDGA,2025-05-22 11:19:59.981,,Completed,,-850.81,19149.19
TEM4Q2H26G,2025-05-22 11:19:59.981,,Completed,20000.0,,20000.0
TEL0OFRQ6C,2025-05-21 21:13:59.981,,Completed,,-33.0,0.0
TEL0OFRQ6C,2025-05-21 21:13:59.981,,Completed,,-2000.0,33.0
TEL0OFRQ6C,2025-05-21 21:13:59.981,of Credit Party,Completed,842.38,,2033.0
TEL0LD5HIQ,2025-05-21 11:10:00.019,,Completed,,-13.0,1190.62
TEL0LD5HIQ,2025-05-21 11:10:00.019,,Completed,,-1000.0,1203.62
TEK4GYSD1W,2025-05-20 12:11:59.971,,Completed,,-1300.0,2203.62
TEK9GYQWXD,2025-05-20 12:11:59.971,,Completed,4286.0,,4286.0
TEK5GYR9KJ,2025-05-20 12:11:59.971,,Completed,,-782.38,3503.62
TEK7G8KS19,2025-05-20 09:06:00.029,,Completed,,-13.0,0.0
TEK7G8KS19,2025-05-20 09:06:00.029,,Completed,,-600.0,13.0
TEK7G8KS19,2025-05-20 09:06:00.029,of Credit Party,Completed,613.0,,613.0
TEK7G42ML7,2025-05-20 08:32:00.038,,Completed,1483.0,,1483.0
TEK5G42XPZ,2025-05-20 08:32:00.038,,Completed,,-1483.0,0.0
TEJ1EQP7A9,2025-05-19 19:50:00.010,,Completed,,-250.0,0.0
TEJ1EQP7A9,2025-05-19 19:50:00.010,of Credit Party,Completed,250.0,,250.0
TEJ9EK8MHD,2025-05-19 19:25:00.019,,Completed,,-7.0,0.0
TEJ9EK8MHD,2025-05-19 19:25:00.019,,Completed,,-500.0,7.0
TEJ9EK8MHD,2025-05-19 19:25:00.019,of Credit Party,Completed,507.0,,507.0
TEJ3CALKE1,2025-05-19 11:42:00.000,,Completed,,-500.0,0.0
TEJ3CALKE1,2025-05-19 11:42:00.000,of Credit Party,Completed,500.0,,500.0
TEH83Y6G04,2025-05-17 14:35:00.010,,Completed,,-20.0,0.0
TEH83Y6G04,2025-05-17 14:35:00.010,,Completed,,-2500.0,20.0
TEH83Y6G04,2025-05-17 14:35:00.010,of Credit Party,Completed,372.95,,2520.0
TEH83Y4VME,2025-05-17 14:35:00.010,,Completed,2000.0,,2147.05
TEH72NZTNZ,2025-05-17 09:29:59.971,,Completed,,-10.0,147.05
TEH72NZTNZ,2025-05-17 09:29:59.971,,Completed,,-1000.0,157.05
TEG31P3LQR,2025-05-16 22:18:00.029,,Completed,,-78.0,1157.05
TEG31P3LQR,2025-05-16 22:18:00.029,,Completed,,-6000.0,1235.05
TEG31F4WPV,2025-05-16 21:08:00.038,,Completed,8000.0,,8000.0
TEG71F54TX,2025-05-16 21:08:00.038,,Completed,,-764.95,7235.05
TEG9Z5XCGN,2025-05-16 17:57:59.990,,Completed,,-1168.0,0.0
TEG9Z5XCGN,2025-05-16 17:57:59.990,of Credit Party,Completed,757.37,,1168.0
TEG2Z3WBS8,2025-05-16 17:48:59.990,,Completed,,-600.0,410.63
TEG0Z31QNW,2025-05-16 17:44:59.971,,Completed,,-100.0,1010.63
TEG3YZZDVZ,2025-05-16 17:30:00.029,,Completed,,-1889.37,1110.63
TEG8YZZCA2,2025-05-16 17:30:00.029,,Completed,3000.0,,3000.0
TEG8X6PFFE,2025-05-16 10:36:59.990,,Completed,,-30.0,0.0
TEG8X6PFFE,2025-05-16 10:36:59.990,of Credit Party,Completed,30.0,,30.0
TEF4UFW9U8,2025-05-15 17:57:59.990,,Completed,,-13.0,0.0
TEF4UFW9U8,2025-05-15 17:57:59.990,,Completed,,-630.0,13.0
TEF4UFW9U8,2025-05-15 17:57:59.990,of Credit Party,Completed,643.0,,643.0
TEE8ORAHIM,2025-05-14 14:03:59.990,,Completed,,-13.0,0.0
TEE8ORAHIM,2025-05-14 14:03:59.990,,Completed,,-1000.0,13.0
TEE8ORAHIM,2025-05-14 14:03:59.990,of Credit Party,Completed,1013.0,,1013.0
TEE8OR4U30,2025-05-14 14:03:00.029,,Completed,,-250.0,0.0
TEE8OR4U30,2025-05-14 14:03:00.029,of Credit Party,Completed,163.27,,250.0
TED8L1SC9W,2025-05-13 17:06:00.000,,Completed,,-650.0,86.73
TED4L1BB14,2025-05-13 17:03:00.029,,Completed,,-3.27,736.73
TED8L1B6HM,2025-05-13 17:03:00.029,,Completed,740.0,,740.0
TED3JEUU4B,2025-05-13 10:36:59.990,,Completed,,-13.0,0.0
TED3JEUU4B,2025-05-13 10:36:59.990,,Completed,,-1000.0,13.0
TED3JEUU4B,2025-05-13 10:36:59.990,of Credit Party,Completed,3.23,,1013.0
TEC0FDGU8S,2025-05-12 12:45:00.000,,Completed,,-13.0,1009.77
TEC0FDGU8S,2025-05-12 12:45:00.000,,Completed,,-1000.0,1022.77
TEB5CUSA0Z,2025-05-11 19:32:00.010,,Completed,,-53.0,2022.77
TEB5CUSA0Z,2025-05-11 19:32:00.010,,Completed,,-3000.0,2075.77
TEB0C2JMB4,2025-05-11 17:19:59.981,,Completed,6221.0,,6221.0
TEB3C2K0F9,2025-05-11 17:19:59.981,,Completed,,-1145.23,5075.77
TEB4A31CG2,2025-05-11 09:38:00.010,,Completed,,-1000.0,0.0
TEB4A31CG2,2025-05-11 09:38:00.010,of Credit Party,Completed,1000.0,,1000.0
TEA18102XH,2025-05-10 19:00:59.990,,Completed,,-7.0,0.0
TEA18102XH,2025-05-10 19:00:59.990,,Completed,,-360.0,7.0
TEA18102XH,2025-05-10 19:00:59.990,of Credit Party,Completed,133.89,,367.0
TEA37A13UR,2025-05-10 16:59:00.010,,Completed,,-12115.0,233.11
TEA279VKOG,2025-05-10 16:57:59.962,,Completed,6000.0,,12348.11
TEA76NXHA3,2025-05-10 14:51:00.000,,Completed,,-4800.0,6348.11
TEA36N0PLX,2025-05-10 14:46:00.019,,Completed,6700.0,,11148.11
TEA96CD02B,2025-05-10 13:41:59.971,,Completed,,-1551.89,4448.11
TEA86CCPQM,2025-05-10 13:41:59.971,,Completed,6000.0,,6000.0
TEA55KY3Y9,2025-05-10 10:47:00.038,,Completed,,-33.0,0.0
TEA55KY3Y9,2025-05-10 10:47:00.038,,Completed,,-2000.0,33.0
TEA55KY3Y9,2025-05-10 10:47:00.038,of Credit Party,Completed,1536.52,,2033.0
TE992KA7W3,2025-05-09 17:19:00.019,,Completed,,-7.0,496.48
TE992KA7W3,2025-05-09 17:19:00.019,,Completed,,-120.0,503.48
TE86X9Q5LW,2025-05-08 18:29:59.971,,Completed,,-7.0,623.48
TE86X9Q5LW,2025-05-08 18:29:59.971,,Completed,,-160.0,630.48
TE74QY1SP0,2025-05-07 12:58:00.019,,Completed,,-16.0,790.48
TE74QY1SP0,2025-05-07 12:58:00.019,Pay Bill Online to 505000 - OLD MUTUAL LIFE ASSURANCE KENYA LIMITED. Acc. OMU000329285,Completed,,-5000.0,806.48
TE75QXZC3V,2025-05-07 12:58:00.019,OD Loan Repayment to 232323 - M-PESA Overdraw,Completed,,-193.52,5806.48
TE72QXZF0I,2025-05-07 12:58:00.019,Transfer from Bank 517819 - IM BANK LIMITED- APP to Customer via API,Completed,6000.0,,6000.0
TE78Q4FVFC,2025-05-07 09:40:00.019,Merchant Payment Fuliza M-Pesa Online to 7188373 - PURE FRESH RONGAI STIMVAK,Completed,,-200.0,0.0
TE78Q4FVFC,2025-05-07 09:40:00.019,OverDraft of Credit Party,Completed,191.6,,200.0
TE64OQNF60,2025-05-06 20:44:00.010,OD Loan Repayment to 232323 - M-PESA Overdraw,Completed,,-91.6,8.4
TE66OQNMHE,2025-05-06 20:44:00.010,Funds received from - 07******038 hesborn otuko,Completed,100.0,,100.0
TE65OQ2HLZ,2025-05-06 20:41:00.038,Customer Transfer of Funds Charge,Completed,,-7.0,0.0
TE65OQ2HLZ,2025-05-06 20:41:00.038,Customer Transfer Fuliza MPesa to - 2547******595 SARAH MURIGI,Completed,,-440.0,7.0
TE65OQ2HLZ,2025-05-06 20:41:00.038,OverDraft of Credit Party,Completed,90.69,,447.0
TE42EN8AZC,2025-05-04 18:49:00.019,Merchant Payment Online to 178456 - QUICK MART RONGAI,Completed,,-3351.0,356.31
TE47EN6SE7,2025-05-04 18:49:00.019,Transfer from Bank 517819 - IM BANK LIMITED- APP to Customer via API,Completed,3000.0,,3707.31
TE35ARSCHB,2025-05-03 20:32:00.038,Merchant Payment Online to 7188373 - PURE FRESH RONGAI STIMVAK,Completed,,-200.0,707.31
TE3792UIC1,2025-05-03 15:53:00.038,Merchant Payment Online to 491847 -            JANDEE GENERAL STORES,Completed,,-100.0,907.31
TE202AMZ8S,2025-05-02 08:33:00.000,Pay Bill Charge,Completed,,-42.0,1007.31
TE202AMZ8S,2025-05-02 08:33:00.000,Pay Bill Online to 247247 - Equity Paybill Account Acc. 0510173643067,Completed,,-6000.0,1049.31
TE232AJSZ9,2025-05-02 08:33:00.000,Transfer from Bank 517819 - IM BANK LIMITED- APP to Customer via API,Completed,7000.0,,7049.31
TE10XSJY2E,2025-05-01 13:25:00.019,Customer Transfer of Funds Charge,Completed,,-7.0,49.31
TE10XSJY2E,2025-05-01 13:25:00.019,Customer Transfer to - 01******452 NAncy okoth,Completed,,-500.0,56.31
TDT2O8M6GG,2025-04-29 13:32:59.971,Merchant Payment Online to 5216942 - MAJID AL FUTTAIM HYPERMARKETS LTD,Completed,,-3546.0,556.31
TDT8O7O4D6,2025-04-29 13:27:00.029,Transfer from Bank 517819 - IM BANK LIMITED- APP to Customer via API,Completed,2000.0,,4102.31
TDT3O0G00X,2025-04-29 12:42:00.029,Merchant Payment Online to 110174 - Quick Mart Rongai Express,Completed,,-400.0,2102.31
TDT1NZXJ0B,2025-04-29 12:38:59.971,Transfer from Bank 517819 - IM BANK LIMITED- APP to Customer via API,Completed,3000.0,,3000.0
TDT3NZXJ0X,2025-04-29 12:38:59.971,OD Loan Repayment to 232323 - M-PESA Overdraw,Completed,,-497.69,2502.31
TDS5KO40ZH,2025-04-28 17:51:59.962,Merchant Payment Fuliza M-Pesa Online to 7188373 - PURE FRESH RONGAI STIMVAK,Completed,,-200.0,0.0
TDS5KO40ZH,2025-04-28 17:51:59.962,OverDraft of Credit Party,Completed,200.0,,200.0
TDS3IVR197,2025-04-28 11:26:59.971,Customer Transfer of Funds Charge,Completed,,-7.0,0.0
TDS3IVR197,2025-04-28 11:26:59.971,Customer Transfer Fuliza MPesa to - 01******452 NAncy okoth,Completed,,-500.0,7.0
TDS3IVR197,2025-04-28 11:26:59.971,OverDraft of Credit Party,Completed,292.76,,507.0
TDS6IHRGBM,2025-04-28 09:54:59.962,Pay Bill Charge,Completed,,-18.0,214.24
TDS6IHRGBM,2025-04-28 09:54:59.962,Pay Bill Online to 505000 - OLD MUTUAL LIFE ASSURANCE KENYA LIMITED. Acc. OMU000329285,Completed,,-15000.0,232.24
TDS1IFAQ0H,2025-04-28 09:38:00.010,OD Loan Repayment to 232323 - M-PESA Overdraw,Completed,,-1767.76,15232.24
TDS2IFAQS0,2025-04-28 09:38:00.010,Transfer from Bank 517819 - IM BANK LIMITED- APP to Customer via API,Completed,17000.0,,17000.0
TDP66D3CCU,2025-04-25 17:12:59.990,Customer Transfer of Funds Charge,Completed,,-13.0,0.0
TDP66D3CCU,2025-04-25 17:12:59.990,Customer Transfer Fuliza MPesa to - 2547******730 BENSON MAINA,Completed,,-1000.0,13.0
TDP66D3CCU,2025-04-25 17:12:59.990,OverDraft of Credit Party,Completed,1013.0,,1013.0
TDP46AZ81Y,2025-04-25 17:01:59.981,,Completed,,-1700.0,0.0
TDP46AZ81Y,2025-04-25 17:01:59.981,of Credit Party,Completed,694.48,,1700.0
TDP162YY41,2025-04-25 16:16:59.981,,Completed,,-80.0,1005.52
TDP162RE93,2025-04-25 16:14:59.971,,Completed,,-827.0,1085.52
TDP55ZO1KP,2025-04-25 15:56:59.971,,Completed,,-10.0,1912.52
TDP55ZO1KP,2025-04-25 15:56:59.971,,Completed,,-819.0,1922.52
TDP05VRPDO,2025-04-25 15:33:00.029,,Completed,,-23.0,2741.52
TDP05VRPDO,2025-04-25 15:33:00.029,,Completed,,-1480.0,2764.52
TDP35O55N1,2025-04-25 14:44:59.971,,Completed,,-6300.0,4244.52
TDP45144WI,2025-04-25 12:22:00.019,,Completed,12000.0,,12000.0
TDP9513XJN,2025-04-25 12:22:00.019,,Completed,,-1455.48,10544.52
TDP64UIB94,2025-04-25 11:37:59.981,,Completed,,-1000.0,0.0
TDP64UIB94,2025-04-25 11:37:59.981,of Credit Party,Completed,1000.0,,1000.0
TDO62UDIGC,2025-04-24 20:15:59.962,,Completed,,-200.0,0.0
TDO62UDIGC,2025-04-24 20:15:59.962,of Credit Party,Completed,200.0,,200.0
TDO42HS886,2025-04-24 19:25:00.019,,Completed,,-13.0,0.0
TDO42HS886,2025-04-24 19:25:00.019,,Completed,,-550.0,13.0
TDO42HS886,2025-04-24 19:25:00.019,of Credit Party,Completed,241.06,,563.0
TDN8VFMKPK,2025-04-23 14:21:59.990,,Completed,,-500.0,321.94
TDN4VEZ2FM,2025-04-23 14:17:00.010,,Completed,,-506.0,821.94
TDN3VCOR1X,2025-04-23 14:01:59.981,,Completed,,-7.0,1327.94
TDN3VCOR1X,2025-04-23 14:01:59.981,,Completed,,-240.0,1334.94
TDN2VCCYKI,2025-04-23 13:59:59.971,,Completed,,-1425.06,1574.94
TDN9VCCMPR,2025-04-23 13:59:59.971,,Completed,3000.0,,3000.0
TDL3M9PLD3,2025-04-21 12:56:59.971,,Completed,,-23.0,0.0
TDL3M9PLD3,2025-04-21 12:56:59.971,,Completed,,-1250.0,23.0
TDL3M9PLD3,2025-04-21 12:56:59.971,of Credit Party,Completed,1273.0,,1273.0
TDK9KBJJY1,2025-04-20 20:37:59.981,,Completed,,-200.0,0.0
TDK9KBJJY1,2025-04-20 20:37:59.981,of Credit Party,Completed,116.56,,200.0
TDJ3EEQBK3,2025-04-19 15:33:00.029,,Completed,,-500.0,83.44
TDJ2EEKIKQ,2025-04-19 15:31:59.981,,Completed,2000.0,,2000.0
TDJ5EEKP8T,2025-04-19 15:31:59.981,,Completed,,-1416.56,583.44
TDJ5EDXH53,2025-04-19 15:27:59.962,,Completed,,-1109.0,0.0
TDJ5EDXH53,2025-04-19 15:27:59.962,of Credit Party,Completed,1109.0,,1109.0
TDJ1ECN3M7,2025-04-19 15:18:59.962,,Completed,1555.0,,1555.0
TDJ5ECN4FH,2025-04-19 15:18:59.962,,Completed,,-1555.0,0.0
TDH350RDJJ,2025-04-17 15:26:00.038,,Completed,,-7.0,0.0
TDH350RDJJ,2025-04-17 00:00:00.000,,Completed,,-310.0,7.0
TDH350RDJJ,2025-04-17 00:00:00.000,of Credit,Completed,317.0,,317.0
TDH2424DP4,2025-04-17 00:00:00.000,,Completed,,-7.0,0.0
TDH2424DP4,2025-04-17 00:00:00.000,,Completed,,-160.0,7.0
TDH2424DP4,2025-04-17 00:00:00.000,of Credit,Completed,167.0,,167.0
TDH62ZXMNG,2025-04-17 00:00:00.000,,Completed,,-380.0,0.0
TDH62ZXMNG,2025-04-17 00:00:00.000,of Credit,Completed,380.0,,380.0
TDG61CKW2E,2025-04-16 00:00:00.000,,Completed,,-23.0,0.0
TDG61CKW2E,2025-04-16 00:00:00.000,,Completed,,-1150.0,23.0
TDG61CKW2E,2025-04-16 00:00:00.000,of Credit,Completed,969.13,,1173.0
TDG418TEZ2,2025-04-16 00:00:00.000,,Completed,,-80.0,203.87
TDG718LIOP,2025-04-16 00:00:00.000,,Completed,,-50.0,283.87
TDG617B124,2025-04-16 00:00:00.000,,Completed,,-380.0,333.87
TDG216CA5I,2025-04-16 00:00:00.000,,Completed,,-400.0,713.87
TDG411C0FU,2025-04-16 00:00:00.000,,Completed,,-1015.0,1113.87
TDG310GY75,2025-04-16 00:00:00.000,,Completed,,-1951.0,2128.87
TDG0101WTM,2025-04-16 00:00:00.000,,Completed,,-920.13,4079.87
TDG710276V,2025-04-16 00:00:00.000,,Completed,5000.0,,5000.0
TDG6ZT293S,2025-04-16 00:00:00.000,,Completed,,-5.0,0.0
TDG6ZT293S,2025-04-16 00:00:00.000,,Completed,,-450.0,5.0
TDG6ZT293S,2025-04-16 00:00:00.000,of Credit,Completed,455.0,,455.0
TDF9WE9TBJ,2025-04-15 00:00:00.000,,Completed,,-200.0,0.0
TDF9WE9TBJ,2025-04-15 00:00:00.000,of Credit,Completed,200.0,,200.0
TDE0OR7FUC,2025-04-14 00:00:00.000,,Completed,,-710.0,0.0
TDE0OR7FUC,2025-04-14 00:00:00.000,of Credit,Completed,256.01,,710.0
TDE0OR5XWO,2025-04-14 00:00:00.000,,Completed,,-1546.01,453.99
TDE6OR6310,2025-04-14 00:00:00.000,,Completed,2000.0,,2000.0
TDC0FQXWWW,2025-04-12 00:00:00.000,,Completed,,-100.0,0.0
TDC0FQXWWW,2025-04-12 00:00:00.000,of Credit,Completed,100.0,,100.0
TDC5FEOQY7,2025-04-12 00:00:00.000,,Completed,,-13.0,0.0
TDC5FEOQY7,2025-04-12 00:00:00.000,,Completed,,-600.0,13.0
TDC5FEOQY7,2025-04-12 00:00:00.000,of Credit,Completed,613.0,,613.0
TDA7870IF9,2025-04-10 00:00:00.000,,Completed,,-200.0,0.0
TDA7870IF9,2025-04-10 00:00:00.000,of Credit,Completed,200.0,,200.0
TDA47AT5JE,2025-04-10 00:00:00.000,,Completed,,-5.0,0.0
TDA47AT5JE,2025-04-10 00:00:00.000,,Completed,,-250.0,5.0
TDA47AT5JE,2025-04-10 00:00:00.000,of Credit,Completed,255.0,,255.0
TD87X1JDZV,2025-04-08 00:00:00.000,,Completed,,-250.0,0.0
TD87X1JDZV,2025-04-08 00:00:00.000,of Credit,Completed,250.0,,250.0
TD87X1293T,2025-04-08 16:16:59.981,,Completed,,-510.0,0.0
TD87X1293T,2025-04-08 16:16:59.981,of Credit Party,Completed,100.82,,510.0
TD59KQOYYB,2025-04-05 20:48:59.990,,Completed,,-7.0,409.18
TD59KQOYYB,2025-04-05 20:48:59.990,,Completed,,-190.0,416.18
TD57KQG8PH,2025-04-05 20:48:00.029,,Completed,,-200.0,606.18
TD48E0RP0C,2025-04-04 16:00:00.029,,Completed,,-30.0,806.18
TD40E0J75K,2025-04-04 15:58:00.019,,Completed,,-20.0,836.18
TD43DZAREJ,2025-04-04 15:51:00.029,,Completed,,-143.82,856.18
TD41DZACN3,2025-04-04 15:51:00.029,,Completed,1000.0,,1000.0
TD44DYROSS,2025-04-04 15:47:59.971,,Completed,,-65.0,0.0
TD44DYROSS,2025-04-04 15:47:59.971,of Credit Party,Completed,65.0,,65.0
TD47DY4HAT,2025-04-04 15:44:00.038,,Completed,,-500.0,0.0
TD47DY4HAT,2025-04-04 15:44:00.038,of Credit Party,Completed,77.39,,500.0
TD43D7J97N,2025-04-04 13:03:00.000,,Completed,,-60.0,422.61
TD40D7AV9K,2025-04-04 13:00:59.990,,Completed,,-600.0,482.61
TD43D74WVB,2025-04-04 13:00:00.029,,Completed,,-1917.39,1082.61
TD40D753K2,2025-04-04 13:00:00.029,,Completed,3000.0,,3000.0
TD388OAIYY,2025-04-03 14:12:00.029,,Completed,,-358.0,0.0
TD388OAIYY,2025-04-03 14:12:00.029,of Credit Party,Completed,358.0,,358.0
TD377W22I1,2025-04-03 11:15:00.000,,Completed,,-13.0,0.0
TD377W22I1,2025-04-03 11:15:00.000,,Completed,,-1000.0,13.0
TD377W22I1,2025-04-03 11:15:00.000,of Credit Party,Completed,1013.0,,1013.0
TD204YS9SW,2025-04-02 18:09:00.000,,Completed,,-7.0,0.0
TD204YS9SW,2025-04-02 18:09:00.000,,Completed,,-300.0,7.0
TD204YS9SW,2025-04-02 18:09:00.000,of Credit Party,Completed,307.0,,307.0
TD243KSBNY,2025-04-02 13:16:00.019,,Completed,,-7.0,0.0
TD243KSBNY,2025-04-02 13:16:00.019,,Completed,,-500.0,7.0
TD243KSBNY,2025-04-02 13:16:00.019,of Credit Party,Completed,220.4,,507.0
TD17YOJ4HT,2025-04-01 16:45:59.990,,Completed,,-42.0,286.6
TD17YOJ4HT,2025-04-01 16:45:59.990,,Completed,,-5010.0,328.6
TD13YOD4HL,2025-04-01 16:45:00.029,,Completed,,-42.0,5338.6
TD13YOD4HL,2025-04-01 16:45:00.029,,Completed,,-6000.0,5380.6
TD12YO75IO,2025-04-01 16:43:59.981,,Completed,,-199.4,11380.6
TD14YO737O,2025-04-01 16:43:59.981,,Completed,11580.0,,11580.0
TCV6TXGHVU,2025-03-31 16:27:00.029,,Completed,,-200.0,0.0
TCV6TXGHVU,2025-03-31 16:27:00.029,of Credit Party,Completed,197.42,,200.0
TCV6TDELCC,2025-03-31 14:19:59.981,,Completed,,-1700.0,2.58
TCV4TD8HOS,2025-03-31 14:19:00.019,,Completed,3000.0,,3000.0
TCV3TD8GCP,2025-03-31 14:19:00.019,,Completed,,-1297.42,1702.58
TCU2OFAB8E,2025-03-30 12:11:00.010,,Completed,,-3527.0,0.0
TCU2OFAB8E,2025-03-30 12:11:00.010,of Credit Party,Completed,1284.57,,3527.0
TCU8OF3ZQ0,2025-03-30 12:09:59.962,,Completed,3400.0,,3400.0
TCU5OF4ARF,2025-03-30 12:09:59.962,,Completed,,-1157.57,2242.43
TCU2OEYCSA,2025-03-30 12:09:00.000,,Completed,0.0,,0.0
TCT9KVL85J,2025-03-29 16:27:59.990,,Completed,,-70.0,0.0
TCT9KVL85J,2025-03-29 16:27:59.990,of Credit Party,Completed,70.0,,70.0
TCT3JZUOCN,2025-03-29 13:16:59.981,,Completed,,-57.0,0.0
TCT3JZUOCN,2025-03-29 13:16:59.981,,Completed,,-4000.0,57.0
TCT3JZUOCN,2025-03-29 13:16:59.981,of Credit Party,Completed,1076.1,,4057.0
TCS1GRTO4V,2025-03-28 18:27:59.962,,Completed,,-100.0,2980.9
TCR6CIOKJS,2025-03-27 19:18:59.990,,Completed,,-1556.0,3080.9
TCR3CHKOC3,2025-03-27 19:14:59.971,,Completed,,-1580.1,4636.9
TCR7CHJMJD,2025-03-27 19:14:59.971,,Completed,6217.0,,6217.0
TCR3A5G4R1,2025-03-27 10:50:00.010,,Completed,,-13.0,0.0
TCR3A5G4R1,2025-03-27 10:50:00.010,,Completed,,-1000.0,13.0
TCR3A5G4R1,2025-03-27 10:50:00.010,of Credit Party,Completed,1013.0,,1013.0
TCQ86WVNPG,2025-03-26 16:09:59.990,,Completed,,-200.0,0.0
TCQ86WVNPG,2025-03-26 16:09:59.990,of Credit Party,Completed,200.0,,200.0
TCP01MMI7A,2025-03-25 12:40:00.019,,Completed,,-90.0,0.0
TCP01MMI7A,2025-03-25 12:40:00.019,,Completed,,-10000.0,90.0
TCP01MMI7A,2025-03-25 12:40:00.019,of Credit Party,Completed,351.45,,10090.0
TCP81MJ9IY,2025-03-25 12:40:00.019,,Completed,,-1602.45,9738.55
TCP41MIP08,2025-03-25 12:40:00.019,,Completed,11341.0,,11341.0
TCP415P7YM,2025-03-25 10:38:00.038,,Completed,,-1000.0,0.0
TCP415P7YM,2025-03-25 10:38:00.038,of Credit Party,Completed,1000.0,,1000.0
TCO4YT7NRO,2025-03-24 21:11:59.971,,Completed,,-13.0,0.0
TCO4YT7NRO,2025-03-24 21:11:59.971,,Completed,,-680.0,13.0
TCO4YT7NRO,2025-03-24 21:11:59.971,of Credit Party,Completed,586.58,,693.0
TCM8OHNZTK,2025-03-22 16:02:00.038,,Completed,,-200.0,106.42
TCM9NGCC29,2025-03-22 11:50:00.038,,Completed,,-25.0,306.42
TCM9NGCC29,2025-03-22 11:50:00.038,,Completed,,-3000.0,331.42
TCM3NFU6HH,2025-03-22 11:46:00.019,,Completed,,-3705.0,3331.42
TCJ0AER19O,2025-03-19 12:49:59.981,,Completed,,-40.0,7036.42
TCJ8AE3XX0,2025-03-19 12:45:59.962,,Completed,,-199.0,7076.42
TCJ6AB9HT0,2025-03-19 12:24:59.990,,Completed,,-400.0,7275.42
TCJ1AB2YBN,2025-03-19 12:24:00.029,Customer Transfer of Funds Charge,Completed,,-13.0,7675.42
TCJ1AB2YBN,2025-03-19 12:24:00.029,Customer Transfer to - 2547******743 DENNIS WAMURANGA,Completed,,-750.0,7688.42
TCJ4AAPTEQ,2025-03-19 12:20:59.971,Merchant Payment Online to 110174 - Quick Mart Rongai Express,Completed,,-4354.0,8438.42
TCJ3AA3BLN,2025-03-19 12:17:00.038,"Receive International Transfer From 573388 - TERRAPAY MONEY TRANSFER SERVICES
(KENYA) LIMITED. Original conversation ID is TPTW000125114791.",Completed,10698.0,,12792.42
TCJ5A2CGRX,2025-03-19 11:19:59.981,Transfer from Bank 517819 - IM BANK LIMITED- APP to Customer via API,Completed,2000.0,,2094.42
TCH71U8WDX,2025-03-17 13:39:00.000,Customer Transfer of Funds Charge,Completed,,-7.0,94.42
TCH71U8WDX,2025-03-17 13:39:00.000,Customer Transfer to - 07******722 BRIAN KARIMI,Completed,,-230.0,101.42
TCF5UMBPMP,2025-03-15 22:02:00.038,Customer Transfer of Funds Charge,Completed,,-13.0,331.42
TCF5UMBPMP,2025-03-15 22:02:00.038,Customer Transfer to - 2547******651 NANCY OKOTH,Completed,,-1000.0,344.42
TCF6SMX9NG,2025-03-15 16:09:59.990,Customer Transfer of Funds Charge,Completed,,-13.0,1344.42
TCF6SMX9NG,2025-03-15 16:09:59.990,Customer Transfer to - 2547******472 DORCAS NZILI,Completed,,-530.0,1357.42
TCF6SMU14G,2025-03-15 16:09:59.990,Customer Transfer of Funds Charge,Completed,,-53.0,1887.42
TCF6SMU14G,2025-03-15 16:09:59.990,Customer Transfer to - 2547******472 DORCAS NZILI,Completed,,-3500.0,1940.42
TCF2RVDW8G,2025-03-15 13:12:59.962,Merchant Payment Online to 7862004 - Art Caffe Market Naivasha,Completed,,-2160.0,5440.42
TCF0RV2ZKU,2025-03-15 13:11:00.038,OD Loan Repayment to 232323 - M-PESA Overdraw,Completed,,-399.58,7600.42
TCF9RV337N,2025-03-15 13:11:00.038,Transfer from Bank 517819 - IM BANK LIMITED- APP to Customer via API,Completed,8000.0,,8000.0
TCD8KNW6Y8,2025-03-13 19:52:59.981,Merchant Payment Fuliza M-Pesa Online to 7188373 - PURE FRESH RONGAI STIMVAK,Completed,,-200.0,0.0
TCD8KNW6Y8,2025-03-13 19:52:59.981,OverDraft of Credit Party,Completed,200.0,,200.0
TCD9KCNVBR,2025-03-13 19:09:59.990,Customer Transfer Fuliza MPesa to - 2547******915 CHARLES NDEREBA,Completed,,-100.0,0.0
TCD9KCNVBR,2025-03-13 19:09:59.990,OverDraft of Credit Party,Completed,100.0,,100.0
TCD5KAWQX9,2025-03-13 19:03:00.000,Merchant Payment Fuliza M-Pesa Online to 7932003 - Alfred Mutembei Kagea,Completed,,-30.0,0.0
TCD5KAWQX9,2025-03-13 19:03:00.000,OverDraft of Credit Party,Completed,30.0,,30.0
TCD8K8LTXM,2025-03-13 18:53:00.038,"Merchant Payment Fuliza M-Pesa Online to 6425769 -
BRIMAR WATER KIOSK 2",Completed,,-10.0,0.0
TCD8K8LTXM,2025-03-13 18:53:00.038,OverDraft of Credit Party,Completed,10.0,,10.0
TCD6K8E4UU,2025-03-13 18:51:59.990,Customer Transfer of Funds Charge,Completed,,-7.0,0.0
TCD6K8E4UU,2025-03-13 18:51:59.990,Customer Transfer Fuliza MPesa to - 07******722 BRIAN KARIMI,Completed,,-120.0,7.0
TCD6K8E4UU,2025-03-13 18:51:59.990,OverDraft of Credit Party,Completed,55.62,,127.0
TCD0JA77AC,2025-03-13 15:40:59.981,Customer Transfer to - 2547******688 NAOMI MUTURIA,Completed,,-20.0,71.38
TCD8J8JR1E,2025-03-13 15:29:00.010,Merchant Payment Online to 491847 -            JANDEE GENERAL STORES,Completed,,-50.0,91.38
TCC7E284QD,2025-03-12 12:45:59.962,Customer Transfer of Funds Charge,Completed,,-7.0,141.38
TCC7E284QD,2025-03-12 12:45:59.962,Customer Transfer to - 07******636 MILKA NYAKWEBA,Completed,,-120.0,148.38
TCC2DT8PIO,2025-03-12 11:44:59.971,Merchant Payment Online to 7605335 - VICTORY FARMS - RONGAI,Completed,,-766.0,268.38
TCC1DT6RCT,2025-03-12 11:44:59.971,OD Loan Repayment to 232323 - M-PESA Overdraw,Completed,,-1465.62,1034.38
TCC3DT6HWL,2025-03-12 11:44:59.971,Transfer from Bank 517819 - IM BANK LIMITED- APP to Customer via API,Completed,2500.0,,2500.0
TCA46QH9JC,2025-03-10 19:02:00.038,Pay Bill Charge,Completed,,-10.0,0.0
TCA46QH9JC,2025-03-10 19:02:00.038,"Pay Bill Online Fuliza M-Pesa to 888880 - KPLC PREPAID Acc.
14467012614",Completed,,-700.0,10.0
TCA46QH9JC,2025-03-10 19:02:00.038,,Completed,710.0,,710.0
TC76T89WP8,2025-03-07 22:14:00.010,Charge,Completed,,-48.0,0.0
TC76T89WP8,2025-03-07 22:14:00.010,,Completed,,-10000.0,48.0
TC76T89WP8,2025-03-07 22:14:00.010,,Completed,729.22,,10048.0
TC72T7ZN80,2025-03-07 22:12:00.000,,Completed,,-1973.22,9318.78
TC72T7ZBBO,2025-03-07 22:12:00.000,,Completed,11292.0,,11292.0
TC63MLELZ5,2025-03-06 16:47:00.038,,Completed,,-33.0,0.0
TC63MLELZ5,2025-03-06 16:47:00.038,,Completed,,-2500.0,33.0
TC63MLELZ5,2025-03-06 16:47:00.038,,Completed,1953.68,,2533.0
TC63MK7ISD,2025-03-06 16:39:00.000,Charge,Completed,,-5.0,579.32
TC63MK7ISD,2025-03-06 16:39:00.000,,Completed,,-200.0,584.32
TC58JHM0MS,2025-03-05 21:11:00.010,Charge,Completed,,-42.0,784.32
TC58JHM0MS,2025-03-05 21:11:00.010,,Completed,,-5010.0,826.32
TC56JHHJJK,2025-03-05 21:11:00.010,,Completed,3400.0,,5836.32
TC50JH7AFM,2025-03-05 21:09:00.000,,Completed,0.0,,2436.32
TC56JGOYGC,2025-03-05 21:06:59.990,Charge,Completed,,-42.0,2436.32
TC56JGOYGC,2025-03-05 21:06:59.990,,Completed,,-6000.0,2478.32
TC53JGADPZ,2025-03-05 21:04:59.981,,Completed,7000.0,,8478.32
TC59I45417,2025-03-05 17:37:00.019,,Completed,,-53.0,1478.32
TC59I45417,2025-03-05 17:37:00.019,,Completed,,-2880.0,1531.32
TC50GTF34S,2025-03-05 12:36:59.962,Charge,Completed,,-5.0,4411.32
TC50GTF34S,2025-03-05 12:36:59.962,,Completed,,-500.0,4416.32
TC41D3V9N7,2025-03-04 16:45:00.029,,Completed,4280.0,,4916.32
TC294PN4V7,2025-03-02 19:54:00.029,Charge,Completed,,-25.0,636.32
TC294PN4V7,2025-03-02 19:54:00.029,,Completed,,-3000.0,661.32
TC2825YVMY,2025-03-02 10:47:00.038,,Completed,,-1254.68,3661.32
TC2925YMYH,2025-03-02 10:47:00.038,,Completed,4916.0,,4916.0
TC13YM4U85,2025-03-01 18:35:00.038,Charge,Completed,,-20.0,0.0
TC13YM4U85,2025-03-01 18:35:00.038,,Completed,,-1688.0,20.0
TC13YM4U85,2025-03-01 18:35:00.038,,Completed,1242.25,,1708.0
TC14Y16WB0,2025-03-01 16:48:59.962,,Completed,,-7.0,465.75
TC14Y16WB0,2025-03-01 16:48:59.962,,Completed,,-220.0,472.75
TC11XYATW3,2025-03-01 16:32:00.010,,Completed,,-149.0,692.75
TC19XXNY1Z,2025-03-01 16:29:00.038,,Completed,,-1355.0,841.75
TC17XU408R,2025-03-01 16:07:00.019,,Completed,,-1803.25,2196.75
TC17XU3YRZ,2025-03-01 16:07:00.019,,Completed,4000.0,,4000.0
TC19X8XK3R,2025-03-01 13:56:00.038,,Completed,,-33.0,0.0
TC19X8XK3R,2025-03-01 13:56:00.038,,Completed,,-1600.0,33.0
TC19X8XK3R,2025-03-01 13:56:00.038,,Completed,1633.0,,1633.0
TBS4RCEWYU,2025-02-28 09:58:00.019,Customer Transfer of Funds Charge,Completed,,-53.0,0.0
TBS4RCEWYU,2025-02-28 09:58:00.019,Customer Transfer Fuliza MPesa to - 2547******885 SHALLINE ONTIRI,Completed,,-3000.0,53.0
TBS4RCEWYU,2025-02-28 09:58:00.019,OverDraft of Credit Party,Completed,152.39,,3053.0
TBS6RC531S,2025-02-28 09:56:59.971,Transfer from Bank 517819 - IM BANK LIMITED- APP to Customer via API,Completed,2832.0,,2900.61
TBR9NZ1G9P,2025-02-27 15:04:59.981,Customer Transfer of Funds Charge,Completed,,-13.0,68.61
TBR9NZ1G9P,2025-02-27 15:04:59.981,Customer Transfer to - 07******636 MILKA NYAKWEBA,Completed,,-650.0,81.61
TBR1NJBY1D,2025-02-27 13:23:00.010,Customer Transfer of Funds Charge,Completed,,-7.0,731.61
TBR1NJBY1D,2025-02-27 13:23:00.010,Customer Transfer to - 2547******595 SARAH MURIGI,Completed,,-290.0,738.61
TBQ8ID9DLO,2025-02-26 11:17:00.010,Pay Bill Charge,Completed,,-16.0,1028.61
TBQ8ID9DLO,2025-02-26 11:17:00.010,Pay Bill Online to 505000 - OLD MUTUAL LIFE ASSURANCE KENYA LIMITED. Acc. OMU000329285,Completed,,-5000.0,1044.61
TBQ9ID4P77,2025-02-26 11:15:59.962,Pay Bill Charge,Completed,,-20.0,6044.61
TBQ9ID4P77,2025-02-26 11:15:59.962,Pay Bill Online to 850436 - HAZINA SACCO LTD Acc. 37325314DEP,Completed,,-2500.0,6064.61
TBQ0IBWQ9E,2025-02-26 11:08:00.010,Pay Bill Charge,Completed,,-20.0,8564.61
TBQ0IBWQ9E,2025-02-26 11:08:00.010,Pay Bill Online to 850436 - HAZINA SACCO LTD Acc. 33826744DEP,Completed,,-2500.0,8584.61
TBQ6I314FA,2025-02-26 10:07:59.981,Pay Bill Charge,Completed,,-48.0,11084.61
TBQ6I314FA,2025-02-26 10:07:59.981,Pay Bill Online to 400200 - Co- operative Bank Money Transfer Acc. 01116572103600,Completed,,-8000.0,11132.61
TBQ7HNPQXN,2025-02-26 08:17:59.971,OD Loan Repayment to 232323 - M-PESA Overdraw,Completed,,-867.39,19132.61
TBQ7HNPN7H,2025-02-26 08:17:59.971,Transfer from Bank 517819 - IM BANK LIMITED- APP to Customer via API,Completed,20000.0,,20000.0
TBP7EFEM4X,2025-02-25 13:32:59.971,Pay Bill Online Fuliza M-Pesa to 200200 - Safaricom Post Paid Acc. 254729920461,Completed,,-1000.0,0.0
TBP7EFEM4X,2025-02-25 13:32:59.971,OverDraft of Credit Party,Completed,858.8,,1000.0
TBP2DWFACK,2025-02-25 11:21:59.990,OD Loan Repayment to 232323 - M-PESA Overdraw,Completed,,-958.8,141.2
TBP1DWF871,2025-02-25 11:21:59.990,Salary Payment from 504900 - NCBA BANK via API. Original conversation ID is FTC250225DFVQ.,Completed,1100.0,,1100.0
TBN87E3VE4,2025-02-23 19:54:00.029,Merchant Payment Fuliza M-Pesa Online to 7188373 - PURE FRESH RONGAI STIMVAK,Completed,,-200.0,0.0
TBN87E3VE4,2025-02-23 19:54:00.029,OverDraft of Credit Party,Completed,200.0,,200.0
TBN87DYZJA,2025-02-23 19:52:59.981,OD Loan Repayment to 232323 - M-PESA Overdraw,Completed,,-869.0,0.0
TBN27DZ2JG,2025-02-23 19:52:59.981,Transfer from Bank 517819 - IM BANK LIMITED- APP to Customer via API,Completed,869.0,,869.0
TBL3WW8B7X,2025-02-21 17:50:00.038,Merchant Payment Fuliza M-Pesa Online to 5216944 - MAJID AL FUTTAIM HYPERMARKETS LTD,Completed,,-7327.0,0.0
TBL3WW8B7X,2025-02-21 17:50:00.038,OverDraft of Credit Party,Completed,1574.05,,7327.0
TBL0WUM5ZQ,2025-02-21 17:41:00.038,Transfer from Bank 517819 - IM BANK LIMITED- APP to Customer via API,Completed,2000.0,,5752.95
TBL5WHWXER,2025-02-21 16:25:59.981,OD Loan Repayment to 232323 - M-PESA Overdraw,Completed,,-229.05,3752.95
TBL2WHWVB4,2025-02-21 16:25:59.981,Transfer from Bank 517819 - IM BANK LIMITED- APP to Customer via API,Completed,3982.0,,3982.0
TBL5VSNLUH,2025-02-21 13:32:59.971,Pay Bill Charge,Completed,,-10.0,0.0
TBL5VSNLUH,2025-02-21 13:32:59.971,"Pay Bill Online Fuliza M-Pesa to 888880 - KPLC PREPAID Acc.
14467012614",Completed,,-1000.0,10.0
TBL5VSNLUH,2025-02-21 13:32:59.971,OverDraft of Credit Party,Completed,226.78,,1010.0
TBG59TOD5F,2025-02-16 13:41:00.010,Customer Transfer of Funds Charge,Completed,,-7.0,783.22
TBG59TOD5F,2025-02-16 13:41:00.010,Customer Transfer to - 01******452 NAncy okoth,Completed,,-500.0,790.22
TBE0YWO7BM,2025-02-14 11:12:00.029,Merchant Payment Online to 7605335 - VICTORY FARMS - RONGAI,Completed,,-1086.0,1290.22
TBD1VT7WH5,2025-02-13 17:03:59.990,Customer Transfer of Funds Charge,Completed,,-53.0,2376.22
TBD1VT7WH5,2025-02-13 17:03:59.990,Customer Transfer to - 07******544 MARY NASIMIYU,Completed,,-3000.0,2429.22
TBD0UJ1ZGY,2025-02-13 11:46:59.981,Merchant Payment Online to 5216942 - MAJID AL FUTTAIM HYPERMARKETS LTD,Completed,,-3177.0,5429.22
TBC2SL7KOW,2025-02-12 20:26:59.971,Merchant Payment Online to 5216948 - MAJID AL FUTTAIM HYPERMARKETS LTD,Completed,,-467.0,8606.22
TBC0SHCLGG,2025-02-12 20:10:00.019,Customer Transfer of Funds Charge,Completed,,-78.0,9073.22
TBC0SHCLGG,2025-02-12 20:10:00.019,Customer Transfer to - 2547******365 CATHERINE KIRAGU,Completed,,-6448.0,9151.22
TBC6R0E8Y8,2025-02-12 15:40:59.981,Merchant Payment Online to 7654009 -    NIGEL      OUKO,Completed,,-1700.0,15599.22
TBC9R0BO1V,2025-02-12 15:40:00.019,Customer Transfer of Funds Charge,Completed,,-33.0,17299.22
TBC9R0BO1V,2025-02-12 15:40:00.019,Customer Transfer to - 2547******743 DENNIS WAMURANGA,Completed,,-1650.0,17332.22
TBA3J2OYMR,2025-02-10 19:07:00.019,Merchant Payment Online to 7188373 - PURE FRESH RONGAI STIMVAK,Completed,,-200.0,18982.22
TB828Z3A2E,2025-02-08 14:53:00.010,Customer Transfer of Funds Charge,Completed,,-7.0,19182.22
TB828Z3A2E,2025-02-08 14:53:00.010,Customer Transfer to - 07******636 MILKA NYAKWEBA,Completed,,-500.0,19189.22
TB8383LUQF,2025-02-08 11:30:59.990,Merchant Payment Online to 5216944 - MAJID AL FUTTAIM HYPERMARKETS LTD,Completed,,-754.0,19689.22
TB783U9NNU,2025-02-07 12:58:59.981,Pay Bill Charge,Completed,,-48.0,20443.22
TB783U9NNU,2025-02-07 12:58:59.981,Pay Bill Online to 542542 - IM BANK C2B Acc. 00304182876150,Completed,,-10000.0,20491.22
TB69WR16AD,2025-02-06 03:11:59.971,Merchant Payment Online to 7188373 - PURE FRESH RONGAI STIMVAK,Completed,,-200.0,30491.22
TB52T1IM84,2025-02-05 10:54:00.029,Customer Transfer of Funds Charge,Completed,,-108.0,30691.22
TB52T1IM84,2025-02-05 10:54:00.029,Customer Transfer to - 2547******326 OMONDI LOVELL,Completed,,-30000.0,30799.22
TB46RAYV22,2025-02-04 20:28:59.981,Business Payment from 300600 - Equity Bulk Account via API. Original conversation ID is EQAB8D08C73C38E.,Completed,59920.0,,60799.22
TB16EL70U4,2025-02-01 23:51:59.962,Pay Bill Charge,Completed,,-42.0,879.22
TB16EL70U4,2025-02-01 23:51:59.962,Pay Bill Online to 247247 - Equity Paybill Account Acc. 1260184676906,Completed,,-5010.0,921.22
TB15EL5L1X,2025-02-01 23:51:00.000,Pay Bill Charge,Completed,,-42.0,5931.22
TB15EL5L1X,2025-02-01 23:51:00.000,Pay Bill Online to 247247 - Equity Paybill Account Acc. 0510173643067,Completed,,-6000.0,5973.22
TB18DOX25Q,2025-02-01 20:01:00.019,"Receive International Transfer From 573388 - TERRAPAY MONEY TRANSFER SERVICES
(KENYA) LIMITED. Original conversation ID is TPTW000119413995.",Completed,10677.0,,11973.22
TB14CCHPSU,2025-02-01 16:12:00.000,Customer Transfer of Funds Charge,Completed,,-53.0,1296.22
TB14CCHPSU,2025-02-01 16:12:00.000,Customer Transfer to - 01******666 OLIVER MUDOGO,Completed,,-3100.0,1349.22
TB10CC3BZC,2025-02-01 16:09:00.029,Transfer from Bank 517819 - IM BANK LIMITED- APP to Customer via API,Completed,4000.0,,4449.22
TAV570SHE9,2025-01-31 13:38:00.038,Customer Transfer to - 2547******655 JANE MWORIA,Completed,,-80.0,449.22
TAV470EUUI,2025-01-31 13:36:00.029,Customer Transfer of Funds Charge,Completed,,-7.0,529.22
TAV470EUUI,2025-01-31 13:36:00.029,Customer Payment to Small Business to - 2547******796 SAMUEL NJOROGE,Completed,,-110.0,536.22
TAU94E2HGV,2025-01-30 19:34:59.981,Merchant Payment Online to 7188373 - PURE FRESH RONGAI STIMVAK,Completed,,-200.0,646.22
TAS7STOOG1,2025-01-28 11:53:00.010,Customer Transfer of Funds Charge,Completed,,-13.0,846.22
TAS7STOOG1,2025-01-28 11:53:00.010,Customer Transfer to - 07******636 MILKA NYAKWEBA,Completed,,-580.0,859.22
TAS8SLQCGK,2025-01-28 10:54:00.029,Merchant Payment Online to 7605335 - VICTORY FARMS - RONGAI,Completed,,-620.0,1439.22
TAS8SLGLAW,2025-01-28 10:52:00.019,OD Loan Repayment to 232323 - M-PESA Overdraw,Completed,,-1940.78,2059.22
TAS7SLGHKF,2025-01-28 10:52:00.019,Transfer from Bank 517819 - IM BANK LIMITED- APP to Customer via API,Completed,4000.0,,4000.0
TAR1OX6CIX,2025-01-27 13:09:00.029,"Pay Bill Fuliza M-Pesa to 200200
- Safaricom Post Paid Acc. 0729920461",Completed,,-1000.0,0.0
TAR1OX6CIX,2025-01-27 13:09:00.029,OverDraft of Credit Party,Completed,1000.0,,1000.0
TAP2H3GRUY,2025-01-25 15:02:59.971,Merchant Payment Fuliza M-Pesa Online to 7188373 - PURE FRESH RONGAI STIMVAK,Completed,,-200.0,0.0
TAP2H3GRUY,2025-01-25 15:02:59.971,OverDraft of Credit Party,Completed,200.0,,200.0
TAO1CFQAS5,2025-01-24 13:41:00.010,Pay Bill Charge,Completed,,-48.0,0.0
TAO1CFQAS5,2025-01-24 13:41:00.010,Pay Bill Online Fuliza M-Pesa to 247247 - Equity Paybill Account Acc. 0796212105,Completed,,-9700.0,48.0
TAO1CFQAS5,2025-01-24 13:41:00.010,OverDraft of Credit Party,Completed,715.62,,9748.0
TAO7CF3IVN,2025-01-24 13:36:59.990,OD Loan Repayment to 232323 - M-PESA Overdraw,Completed,,-967.62,9032.38
TAO7CF3I3L,2025-01-24 13:36:59.990,Transfer from Bank 517819 - IM BANK LIMITED- APP to Customer via API,Completed,10000.0,,10000.0
TAO0C3AUZA,2025-01-24 12:13:00.019,Merchant Payment Fuliza M-Pesa Online to 7940897 - MOMMIES' CHOICE PRODUCTS LLP,Completed,,-2900.0,0.0
TAO0C3AUZA,2025-01-24 12:13:00.019,OverDraft of Credit Party,Completed,958.03,,2900.0
TAN28W5HF0,2025-01-23 16:30:59.962,Pay Bill Charge,Completed,,-34.0,1941.97
TAN28W5HF0,2025-01-23 16:30:59.962,Pay Bill Online to 329329 - C2B Standard Chartered Bank Acc. 0100409937400,Completed,,-4800.0,1975.97
TAN08TI49C,2025-01-23 16:12:00.000,Transfer from Bank 517819 - IM BANK LIMITED- APP to Customer via API,Completed,5000.0,,6775.97
TAM75G284R,2025-01-22 18:56:59.971,Customer Transfer of Funds Charge,Completed,,-33.0,1775.97
TAM75G284R,2025-01-22 18:56:59.971,Customer Transfer to - 2547******090 VIOLET JEPCHIRCHIR,Completed,,-2030.0,1808.97
TAM65FN7D8,2025-01-22 18:54:59.962,Transfer from Bank 517819 - IM BANK LIMITED- APP to Customer via API,Completed,3000.0,,3838.97
TAM5520P85,2025-01-22 17:46:00.019,OD Loan Repayment to 232323 - M-PESA Overdraw,Completed,,-1161.03,838.97
TAM8520NNK,2025-01-22 17:46:00.019,Transfer from Bank 517819 - IM BANK LIMITED- APP to Customer via API,Completed,2000.0,,2000.0
TAM04S0RIS,2025-01-22 16:43:59.981,Merchant Payment Fuliza M-Pesa Online to 7654009 -    NIGEL OUKO,Completed,,-1700.0,0.0
TAM04S0RIS,2025-01-22 16:43:59.981,OverDraft of Credit Party,Completed,1149.53,,1700.0
TAM54MV9AJ,2025-01-22 16:07:00.019,Customer Transfer of Funds Charge,Completed,,-53.0,550.47
TAM54MV9AJ,2025-01-22 16:07:00.019,Customer Transfer to - 2547******743 DENNIS WAMURANGA,Completed,,-3000.0,603.47
TAM54MQ2ER,2025-01-22 16:05:59.971,OD Loan Repayment to 232323 - M-PESA Overdraw,Completed,,-1396.53,3603.47
TAM84MPPV6,2025-01-22 16:05:59.971,Transfer from Bank 517819 - IM BANK LIMITED- APP to Customer via API,Completed,5000.0,,5000.0
TAM53WY5DX,2025-01-22 12:53:00.038,Merchant Payment Fuliza M-Pesa Online to 7375235 - The Mothership Village,Completed,,-3500.0,0.0
TAM53WY5DX,2025-01-22 12:53:00.038,OverDraft of Credit Party,Completed,1382.7,,3500.0
TAL5YTLG7D,2025-01-21 13:18:59.990,Funds received from - 2547******090 VIOLET JEPCHIRCHIR,Completed,2030.0,,2117.3
TAL5Y8XX8T,2025-01-21 10:45:00.029,Pay Bill Charge,Completed,,-48.0,87.3
TAL5Y8XX8T,2025-01-21 10:45:00.029,Pay Bill Online to 400200 - Co- operative Bank Money Transfer Acc. 01116572103600,Completed,,-8000.0,135.3
TAL1Y8LU1R,2025-01-21 10:43:00.019,Transfer from Bank 517819 - IM BANK LIMITED- APP to Customer via API,Completed,1000.0,,8135.3
TAL4Y8AJ80,2025-01-21 10:41:00.010,Transfer from Bank 517819 - IM BANK LIMITED- APP to Customer via API,Completed,5000.0,,7135.3
TAJ8SG2O8A,2025-01-19 20:14:00.038,Merchant Payment Online to 7188373 - PURE FRESH RONGAI STIMVAK,Completed,,-260.0,2135.3
TAJ1QYWO19,2025-01-19 15:04:59.981,Customer Transfer to - 2547******287 Emmanuel Wafula,Completed,,-100.0,2395.3
TAH0K72DN0,2025-01-17 20:19:59.981,Customer Transfer of Funds Charge,Completed,,-7.0,2495.3
TAH0K72DN0,2025-01-17 20:19:59.981,Customer Transfer to - 07******636 MILKA NYAKWEBA,Completed,,-500.0,2502.3
TAH9JVIWBX,2025-01-17 19:30:59.962,Customer Transfer to - 07******741 HANS MISANGO,Completed,,-100.0,3002.3
TAE14PRGAJ,2025-01-14 09:47:59.971,Customer Transfer of Funds Charge,Completed,,-7.0,3102.3
TAE14PRGAJ,2025-01-14 09:47:59.971,Customer Transfer to - 01******452 NAncy okoth,Completed,,-200.0,3109.3
TAD62X5TWA,2025-01-13 19:18:00.029,Transfer from Bank 517819 - IM BANK LIMITED- APP to Customer via API,Completed,2400.0,,3309.3
TA98L84LD6,2025-01-09 19:12:59.962,Pay Bill Charge,Completed,,-20.0,909.3
TA98L84LD6,2025-01-09 19:12:59.962,Pay Bill Online to 888880 - KPLC PREPAID Acc. 14467012614,Completed,,-2000.0,929.3
TA96L81O1G,2025-01-09 19:12:00.000,Transfer from Bank 517819 - IM BANK LIMITED- APP to Customer via API,Completed,2000.0,,2929.3
TA75ATNGUH,2025-01-07 12:51:59.990,Customer Transfer of Funds Charge,Completed,,-33.0,929.3
TA75ATNGUH,2025-01-07 12:51:59.990,Customer Transfer to - 2547******743 DENNIS WAMURANGA,Completed,,-2000.0,962.3
TA77A1XLXJ,2025-01-07 09:45:59.962,Pay Bill Charge,Completed,,-10.0,2962.3
TA77A1XLXJ,2025-01-07 09:45:59.962,Pay Bill Online to 888880 - KPLC PREPAID Acc. 14467012614,Completed,,-1000.0,2972.3
TA646WRGZS,2025-01-06 15:02:59.971,Merchant Payment Online to 693853 - KRCS Nairobi and Getrude Hospitals Shop,Completed,,-330.0,3972.3
TA615Z83UP,2025-01-06 11:21:59.990,Customer Transfer of Funds Charge,Completed,,-23.0,4302.3
TA615Z83UP,2025-01-06 11:21:59.990,Customer Transfer to - 07******970 Naomi choge,Completed,,-1500.0,4325.3
TA675YTGF3,2025-01-06 11:19:00.019,Transfer from Bank 517819 - IM BANK LIMITED- APP to Customer via API,Completed,4333.0,,5825.3
TA531FAWZZ,2025-01-05 09:00:59.962,Pay Bill Charge,Completed,,-10.0,1492.3
TA531FAWZZ,2025-01-05 09:00:59.962,Pay Bill Online to 850436 - HAZINA SACCO LTD Acc. 37325314DEP,Completed,,-1000.0,1502.3
TA561F0W3A,2025-01-05 08:59:00.038,Pay Bill Charge,Completed,,-10.0,2502.3
TA561F0W3A,2025-01-05 08:59:00.038,Pay Bill Online to 850436 - HAZINA SACCO LTD Acc. 33826744DEP,Completed,,-1000.0,2512.3
TA531EYVPN,2025-01-05 08:57:59.990,Pay Bill Charge,Completed,,-42.0,3512.3
TA531EYVPN,2025-01-05 08:57:59.990,Pay Bill Online to 247247 - Equity Paybill Account Acc. 1260184676906,Completed,,-5010.0,3554.3
TA561EVW12,2025-01-05 08:57:59.990,Pay Bill Charge,Completed,,-42.0,8564.3
TA561EVW12,2025-01-05 08:57:59.990,Pay Bill Online to 247247 - Equity Paybill Account Acc. 0510173643067,Completed,,-6000.0,8606.3
TA501ETHDQ,2025-01-05 08:57:00.029,Transfer from Bank 517819 - IM BANK LIMITED- APP to Customer via API,Completed,13000.0,,14606.3
TA37SMV94X,2025-01-03 11:37:00.019,Merchant Payment Online to 7375235 - The Mothership Village,Completed,,-2975.0,1606.3
TA20OV22QK,2025-01-02 12:35:00.038,Customer Transfer of Funds Charge,Completed,,-7.0,4581.3
TA20OV22QK,2025-01-02 12:35:00.038,Customer Transfer to - 01******452 NAncy okoth,Completed,,-200.0,4588.3
TA26OUXMB6,2025-01-02 12:33:59.990,OD Loan Repayment to 232323 - M-PESA Overdraw,Completed,,-511.7,4788.3
TA22OUXMAS,2025-01-02 12:33:59.990,Transfer from Bank 517819 - IM BANK LIMITED- APP to Customer via API,Completed,5300.0,,5300.0
TA24OMGGU6,2025-01-02 11:32:00.038,Customer Transfer Fuliza MPesa to - 2547******575 DANIEL OLUKUNGA,Completed,,-50.0,0.0
TA24OMGGU6,2025-01-02 11:32:00.038,OverDraft of Credit Party,Completed,50.0,,50.0
TA26OKQYMA,2025-01-02 11:19:00.019,Customer Transfer of Funds Charge,Completed,,-7.0,0.0
TA26OKQYMA,2025-01-02 11:19:00.019,Customer Transfer Fuliza MPesa to - 2547******575 DANIEL OLUKUNGA,Completed,,-215.0,7.0
TA26OKQYMA,2025-01-02 11:19:00.019,OverDraft of Credit Party,Completed,222.0,,222.0
SLV1I9JBCR,2024-12-31 18:51:00.029,Pay Bill Charge,Completed,,-34.0,0.0
SLV1I9JBCR,2024-12-31 18:51:00.029,Pay Bill Online Fuliza M-Pesa to 303030 - Absa Bank Kenya PLC Acc. 2707#,Completed,,-3800.0,34.0
SLV1I9JBCR,2024-12-31 18:51:00.029,OverDraft of Credit Party,Completed,234.63,,3834.0
SLV4I98OXM,2024-12-31 18:49:00.019,Transfer from Bank 517819 - IM BANK LIMITED- APP to Customer via API,Completed,2652.0,,3599.37
SLS064PDNE,2024-12-28 18:27:00.000,Pay Bill Charge,Completed,,-10.0,947.37
SLS064PDNE,2024-12-28 18:27:00.000,Pay Bill Online to 888880 - KPLC PREPAID Acc. 14467012614,Completed,,-1000.0,957.37
SLS65JMXBG,2024-12-28 16:05:59.971,Pay Bill Charge,Completed,,-20.0,1957.37
SLS65JMXBG,2024-12-28 16:05:59.971,Pay Bill Online to 4699282 - URBAN SPACKLE LIMITED Acc. 1918327,Completed,,-1780.0,1977.37
SLS85JFXYM,2024-12-28 16:03:59.962,Transfer from Bank 517819 - IM BANK LIMITED- APP to Customer via API,Completed,2000.0,,3757.37
SLS95JDAV1,2024-12-28 16:03:59.962,OD Loan Repayment to 232323 - M-PESA Overdraw,Completed,,-1242.63,1757.37
SLS35JD5R9,2024-12-28 16:03:59.962,Transfer from Bank 517819 - IM BANK LIMITED- APP to Customer via API,Completed,3000.0,,3000.0
SLQ6V7TKK4,2024-12-26 07:34:00.019,Customer Transfer of Funds Charge,Completed,,-33.0,0.0
SLQ6V7TKK4,2024-12-26 07:34:00.019,Customer Transfer Fuliza MPesa to - 2547******977 DAVID CHOGE,Completed,,-2000.0,33.0
SLQ6V7TKK4,2024-12-26 07:34:00.019,OverDraft of Credit Party,Completed,1208.94,,2033.0
SLQ7V7RBL5,2024-12-26 07:34:00.019,Customer Transfer of Funds Charge,Completed,,-53.0,824.06
SLQ7V7RBL5,2024-12-26 07:34:00.019,Customer Transfer to - 2547******977 DAVID CHOGE,Completed,,-3000.0,877.06
SLP4TVU2LQ,2024-12-25 18:35:00.038,Pay Bill Charge,Completed,,-10.0,3877.06
SLP4TVU2LQ,2024-12-25 18:35:00.038,"Pay Bill Online to 4097275 - ALLADIN  GROUP HOLDINGS
WELL MALL Acc. Alladin",Completed,,-720.0,3887.06
SLP5TVQKLX,2024-12-25 18:33:59.990,OD Loan Repayment to 232323 - M-PESA Overdraw,Completed,,-1597.94,4607.06
SLP4TVPW52,2024-12-25 18:33:59.990,"Receive International Transfer From 573388 - MOBEX MONEY.
Original conversation ID is TPTW000115009499.",Completed,6205.0,,6205.0
SLN3KX0ELZ,2024-12-23 19:12:59.962,Customer Transfer of Funds Charge,Completed,,-33.0,0.0
SLN3KX0ELZ,2024-12-23 19:12:59.962,Customer Transfer Fuliza MPesa to - 2547******743 DENNIS WAMURANGA,Completed,,-2000.0,33.0
SLN3KX0ELZ,2024-12-23 19:12:59.962,OverDraft of Credit Party,Completed,1558.35,,2033.0
SLL2AF8OH8,2024-12-21 11:44:00.010,Pay Bill Online to 200200 - Safaricom Post Paid Acc. 254729920461,Completed,,-1000.0,474.65
SLL4AF4R5S,2024-12-21 11:42:59.962,Transfer from Bank 517819 - IM BANK LIMITED- APP to Customer via API,Completed,1000.0,,1474.65
SLI4WIIZ56,2024-12-18 12:49:59.981,Pay Bill Charge,Completed,,-10.0,474.65
SLI4WIIZ56,2024-12-18 12:49:59.981,Pay Bill Online to 200222 - SHA Acc. CR4035017360050-9,Completed,,-850.0,484.65
SLI4WIGMPQ,2024-12-18 12:49:00.019,Transfer from Bank 517819 - IM BANK LIMITED- APP to Customer via API,Completed,1000.0,,1334.65
SLI4V5BSDQ,2024-12-18 05:42:00.000,Customer Transfer of Funds Charge,Completed,,-7.0,334.65
SLI4V5BSDQ,2024-12-18 05:42:00.000,Customer Transfer to - 01******452 NAncy okoth,Completed,,-500.0,341.65
SLG2QM8TNY,2024-12-16 23:48:00.029,Airtime Purchase,Completed,,-50.0,841.65
SLG5QM56CT,2024-12-16 23:44:59.971,Airtime Purchase,Completed,,-20.0,891.65
SLG6PNYGF8,2024-12-16 19:30:59.962,Merchant Payment Online to 5119190 - RONGAI FRESHFINDS STORE LIMITED,Completed,,-400.0,911.65
SLG5PMJC4D,2024-12-16 19:25:00.019,Customer Transfer to - 2547******444 DAVID MUCHINA,Completed,,-30.0,1311.65
SLG7PKS80L,2024-12-16 19:18:00.029,Merchant Payment Online to 7661021 - MAYAKA BLESSED BUTCHERY,Completed,,-200.0,1341.65
SLG4PI8YKE,2024-12-16 19:07:59.981,Merchant Payment Online to 6434825 - JOSEPH OLUOCH OYOWO VIA NCBA,Completed,,-830.0,1541.65
SLG5PI0VAL,2024-12-16 19:07:00.019,Transfer from Bank 517819 - IM BANK LIMITED- APP to Customer via API,Completed,2000.0,,2371.65
SLE2E9HPM0,2024-12-14 06:58:00.019,KCB M-PESA Loan Repayment from Savings,Completed,0.0,,371.65
SLE3E9G7IT,2024-12-14 06:58:00.019,KCB M-PESA Deposit,Completed,,-3709.0,371.65
SLE6E9EAPO,2024-12-14 06:56:59.971,Transfer from Bank 517819 - IM BANK LIMITED- APP to Customer via API,Completed,2000.0,,4080.65
SLE2E94LSG,2024-12-14 06:53:00.038,,Completed,,-1919.35,2080.65
SLE1E94W3J,2024-12-14 06:53:00.038,,Completed,4000.0,,4000.0
SLD0DNMDE0,2024-12-13 21:26:00.038,,Completed,,-650.0,0.0
SLD0DNMDE0,2024-12-13 21:26:00.038,of Credit Party,Completed,650.0,,650.0
SLD5DLT679,2024-12-13 21:15:00.029,,Completed,,-589.0,0.0
SLD5DLT679,2024-12-13 21:15:00.029,of Credit Party,Completed,589.0,,589.0
SLD1DHXZPX,2024-12-13 20:51:59.962,,Completed,,-100.0,0.0
SLD1DHXZPX,2024-12-13 20:51:59.962,of Credit Party,Completed,100.0,,100.0
SLD1DHT4PX,2024-12-13 20:51:00.000,,Completed,,-70.0,0.0
SLD1DHT4PX,2024-12-13 20:51:00.000,of Credit Party,Completed,70.0,,70.0
SLD3B8LCKV,2024-12-13 13:07:59.981,,Completed,,-70.0,0.0
SLD3B8LCKV,2024-12-13 13:07:59.981,of Credit Party,Completed,70.0,,70.0
SLD7B6X34Z,2024-12-13 12:56:00.010,,Completed,,-7.0,0.0
SLD7B6X34Z,2024-12-13 12:56:00.010,,Completed,,-260.0,7.0
SLD7B6X34Z,2024-12-13 12:56:00.010,of Credit Party,Completed,267.0,,267.0
SLC76ULCZ3,2024-12-12 12:29:59.971,,Completed,,-200.0,0.0
SLC76ULCZ3,2024-12-12 12:29:59.971,of Credit Party,Completed,154.34,,200.0
SLB74CNC2T,2024-12-11 19:18:59.990,,Completed,,-90.0,45.66
SLA4ZURM32,2024-12-10 22:20:00.038,,Completed,,-65.0,135.66
SLA2Z3Y8R0,2024-12-10 19:45:00.029,,Completed,,-7.0,200.66
SLA2Z3Y8R0,2024-12-10 19:45:00.029,,Completed,,-440.0,207.66
SLA7Z3RGGZ,2024-12-10 19:45:00.029,,Completed,,-50.0,647.66
SLA9Z3MO05,2024-12-10 19:43:59.981,,Completed,,-7.0,697.66
SLA9Z3MO05,2024-12-10 19:43:59.981,,Completed,,-150.0,704.66
SLA3YRNAC7,2024-12-10 18:56:00.010,,Completed,,-13.0,854.66
SLA3YRNAC7,2024-12-10 18:56:00.010,,Completed,,-1000.0,867.66
SL92UOZ8WI,2024-12-09 19:34:59.981,,Completed,,-725.0,1867.66
SL91UL3539,2024-12-09 19:20:00.038,,Completed,,-20.0,2592.66
SL91UKZ7VD,2024-12-09 19:18:59.990,,Completed,,-7.0,2612.66
SL91UKZ7VD,2024-12-09 19:18:59.990,,Completed,,-490.0,2619.66
SL99UJKQA9,2024-12-09 19:14:00.010,,Completed,,-100.0,3109.66
SL95RY0SU1,2024-12-09 09:18:59.962,,Completed,,-1790.34,3209.66
SL93RY0S31,2024-12-09 09:18:59.962,,Completed,5000.0,,5000.0
SL88QGTAKW,2024-12-08 19:47:00.038,,Completed,,-5868.0,0.0
SL88QGTAKW,2024-12-08 19:47:00.038,of Credit Party,Completed,1772.61,,5868.0
SL82PT67AA,2024-12-08 17:51:00.000,,Completed,,-230.0,4095.39
SL86PPZWIG,2024-12-08 00:00:00.000,Merchant Payment Online to 863485 - O MARKET FOREST EDGE,Completed,,-120.0,4325.39
SL73N21DDV,2024-12-07 00:00:00.000,"Pay Bill Online to 804200 - EVOPAY LTD Acc.
KDR597V;Hub_Karen Parking",Completed,,-110.0,4445.39
SL75M3Q6M1,2024-12-07 00:00:00.000,Merchant Payment Online to 6793173 -     NETFLEX STORE AND GROCERY,Completed,,-60.0,4555.39
SL72M2MOI4,2024-12-07 00:00:00.000,Pay Bill Charge,Completed,,-42.0,4615.39
SL72M2MOI4,2024-12-07 00:00:00.000,Pay Bill Online to 522533 - Lipa na KCB Acc. 7951150,Completed,,-5150.0,4657.39
SL75LR4567,2024-12-07 00:00:00.000,Merchant Payment Online to 5010794 -               MARGARET KEMUNTO OCHOKI,Completed,,-140.0,9807.39
SL77LLPT0L,2024-12-07 00:00:00.000,OD Loan Repayment to 232323 - M-PESA Overdraw,Completed,,-52.61,9947.39
SL70LLPN2I,2024-12-07 00:00:00.000,Salary Payment from 504900 - NCBA BANK via API. Original conversation ID is FTC241207OZIC.,Completed,10000.0,,10000.0
SL72KIBF4Y,2024-12-07 00:00:00.000,Merchant Payment Fuliza M-Pesa Online to 7188373 - PURE FRESH RONGAI STIMVAK,Completed,,-200.0,0.0
SL72KIBF4Y,2024-12-07 00:00:00.000,OverDraft of Credit Party,Completed,52.08,,200.0
SL61I6IXM9,2024-12-06 00:00:00.000,Customer Transfer of Funds Charge,Completed,,-7.0,147.92
SL61I6IXM9,2024-12-06 00:00:00.000,Customer Payment to Small Business to - 07******212 PETER NYARUA,Completed,,-300.0,154.92
SL61I648B9,2024-12-06 00:00:00.000,Customer Transfer of Funds Charge,Completed,,-33.0,454.92
SL61I648B9,2024-12-06 00:00:00.000,Customer Transfer to - 2547******108 JOEL NZILI,Completed,,-1700.0,487.92
SL69I55F7J,2024-12-06 00:00:00.000,Merchant Payment Online to 496011 -    MEDALLION STEAKHOUSE LTD,Completed,,-210.0,2187.92
SL61HA8PFL,2024-12-06 00:00:00.000,Customer Transfer of Funds Charge,Completed,,-33.0,2397.92
SL61HA8PFL,2024-12-06 00:00:00.000,Customer Transfer to - 01******452 NAncy okoth,Completed,,-1700.0,2430.92
SL69FEVUHR,2024-12-06 00:00:00.000,Customer Transfer of Funds Charge,Completed,,-7.0,4130.92
SL69FEVUHR,2024-12-06 00:00:00.000,Customer Transfer to - 2547******269 PATRICIA WAINAINA,Completed,,-200.0,4137.92
SL60FD1BQY,2024-12-06 00:00:00.000,Withdrawal Charge,Completed,,-29.0,4337.92
SL60FD1BQY,2024-12-06 00:00:00.000,"Customer Withdrawal At Agent Till 2062825 - COWTRACK LTD
Learnington Bookshop",Completed,,-2000.0,4366.92
SL60FB7B42,2024-12-06 00:00:00.000,Merchant Payment Online to 5329482 - JOHN GITHUKU NGANGA,Completed,,-90.0,6366.92
SL63FANII9,2024-12-06 00:00:00.000,Customer Transfer of Funds Charge,Completed,,-13.0,6456.92
SL63FANII9,2024-12-06 00:00:00.000,Customer Transfer to - 2547******921 RONALD MOSE,Completed,,-950.0,6469.92
SL61F4ZYKD,2024-12-06 00:00:00.000,Funds received from - 2547******326 OMONDI LOVELL,Completed,6000.0,,7419.92
SL63F4FZGD,2024-12-06 00:00:00.000,Merchant Payment Online to 5342602 - CARREFOUR RUIRU 05,Completed,,-124.0,1419.92
SL53D9WYGT,2024-12-05 00:00:00.000,Customer Transfer of Funds Charge,Completed,,-7.0,1543.92
SL53D9WYGT,2024-12-05 00:00:00.000,Customer Transfer to - 01******666 OLIVER MUDOGO,Completed,,-400.0,1550.92
SL448F67JO,2024-12-04 00:00:00.000,Customer Transfer of Funds Charge,Completed,,-7.0,1950.92
SL448F67JO,2024-12-04 00:00:00.000,Customer Transfer to - 07******587 Ann Muriungi,Completed,,-150.0,1957.92
SL438EJRHN,2024-12-04 00:00:00.000,Merchant Payment Online to 110174 - Quick Mart Rongai Express,Completed,,-175.0,2107.92
SL428A7V4W,2024-12-04 00:00:00.000,Customer Transfer to - 2547******444 DAVID MUCHINA,Completed,,-50.0,2282.92
SL416YVATB,2024-12-04 00:00:00.000,Pay Bill Charge,Completed,,-10.0,2332.92
SL416YVATB,2024-12-04 00:00:00.000,Pay Bill Online to 888880 - KPLC PREPAID Acc. 14467012614,Completed,,-1000.0,2342.92
SL3334XQIT,2024-12-03 00:00:00.000,Customer Transfer of Funds Charge,Completed,,-33.0,3342.92
SL3334XQIT,2024-12-03 00:00:00.000,Customer Transfer to - 07******544 MARY NASIMIYU,Completed,,-2500.0,3375.92
SL381BHHZ2,2024-12-03 00:00:00.000,Pay Bill Charge,Completed,,-10.0,5875.92
SL381BHHZ2,2024-12-03 09:42:59.990,Pay Bill Online to 850436 - HAZINA SACCO LTD Acc. 37325314DEP,Completed,,-1000.0,5885.92
SL321B9Z0G,2024-12-03 09:42:00.029,Pay Bill Charge,Completed,,-10.0,6885.92
SL321B9Z0G,2024-12-03 09:42:00.029,Pay Bill Online to 850436 - HAZINA SACCO LTD Acc. 33826744DEP,Completed,,-1000.0,6895.92
SL351AUFF9,2024-12-03 09:38:00.010,Pay Bill Charge,Completed,,-62.0,7895.92
SL351AUFF9,2024-12-03 09:38:00.010,Pay Bill Online to 542542 - IM BANK C2B Acc. 01203742076150,Completed,,-20000.0,7957.92
SL321ANDNW,2024-12-03 09:36:59.962,Pay Bill Charge,Completed,,-48.0,27957.92
SL321ANDNW,2024-12-03 09:36:59.962,Pay Bill Online to 542542 - IM BANK C2B Acc. 00304182876150,Completed,,-10000.0,28005.92
SL331ADOZ5,2024-12-03 09:35:00.038,Pay Bill Charge,Completed,,-42.0,38005.92
SL331ADOZ5,2024-12-03 09:35:00.038,Pay Bill Online to 247247 - Equity Paybill Account Acc. 0510173643067,Completed,,-6000.0,38047.92
SL22XSWAFE,2024-12-02 17:17:59.971,Customer Transfer of Funds Charge,Completed,,-7.0,44047.92
SL22XSWAFE,2024-12-02 17:17:59.971,Customer Transfer to - 2547******079 GLADYS NJOKI,Completed,,-120.0,44054.92
SL27XGQCYB,2024-12-02 16:02:00.038,Merchant Payment Online to 5119190 - RONGAI FRESHFINDS STORE LIMITED,Completed,,-400.0,44174.92
SL21XGDJEL,2024-12-02 15:58:59.981,Customer Transfer of Funds Charge,Completed,,-13.0,44574.92
SL21XGDJEL,2024-12-02 15:58:59.981,Customer Payment to Small Business to - 01******662 JOHN KIMANI,Completed,,-620.0,44587.92
SL20XEMZGU,2024-12-02 15:47:59.971,Merchant Payment Online to 986625 - STAREHE BUTCHERY RONGAI,Completed,,-60.0,45207.92
SL20XECS0S,2024-12-02 15:45:59.962,Merchant Payment Online to 914213 - STAREHE BUTCHERY RONGAI 7,Completed,,-1000.0,45267.92
SL27X6917B,2024-12-02 14:50:00.038,Business Payment from 300600 - Equity Bulk Account via API. Original conversation ID is EQA7FE9A3691E10.,Completed,45000.0,,46267.92
SKT1LMN1BX,2024-11-29 19:30:59.962,Customer Transfer of Funds Charge,Completed,,-33.0,1267.92
SKT1LMN1BX,2024-11-29 19:30:59.962,Customer Transfer to - 01******452 NAncy okoth,Completed,,-1700.0,1300.92
SKT7L908O5,2024-11-29 18:33:00.029,Merchant Payment Online to 783381 - Kiddie Kloset,Completed,,-2000.0,3000.92
SKT5L7AJOJ,2024-11-29 18:24:59.990,Merchant Payment Online to 7527615 - Naivas Rongai,Completed,,-1215.0,5000.92
SKT5L0C7CX,2024-11-29 17:51:00.000,Merchant Payment Online to 7733814 - JOARK SPA VIA COOP,Completed,,-500.0,6215.92
SKT1L02UNP,2024-11-29 17:48:59.990,Customer Transfer of Funds Charge,Completed,,-7.0,6715.92
SKT1L02UNP,2024-11-29 17:48:59.990,Customer Transfer to - 07******144 stellah charles,Completed,,-200.0,6722.92
SKT0KL5L5I,2024-11-29 16:23:59.971,Merchant Payment Online to 491847 -            JANDEE GENERAL STORES,Completed,,-100.0,6922.92
SKT4JLXNC6,2024-11-29 12:31:00.019,Customer Transfer of Funds Charge,Completed,,-53.0,7022.92
SKT4JLXNC6,2024-11-29 12:31:00.019,Customer Transfer to - 2547******045 JOYCE WAITHIRA,Completed,,-2600.0,7075.92
SKT8JA0JTG,2024-11-29 11:08:00.010,Merchant Payment Online to 900748 - GEMELLI  LIMITED,Completed,,-8469.0,9675.92
SKT8J4G4Z0,2024-11-29 10:27:59.990,OD Loan Repayment to 232323 - M-PESA Overdraw,Completed,,-1855.08,18144.92
SKT8J4FYFG,2024-11-29 10:27:59.990,Salary Payment from 504900 - NCBA BANK via API. Original conversation ID is FTC241129MWZD.,Completed,20000.0,,20000.0
SKS0FSA2MI,2024-11-28 14:51:59.962,Customer Transfer Fuliza MPesa to - 2547******565 EUCABETH NYAKWEBA,Completed,,-90.0,0.0
SKS0FSA2MI,2024-11-28 14:51:59.962,OverDraft of Credit Party,Completed,90.0,,90.0
SKS9FL2NTT,2024-11-28 14:03:00.029,Customer Transfer of Funds Charge,Completed,,-33.0,0.0
SKS9FL2NTT,2024-11-28 14:03:00.029,Customer Transfer Fuliza MPesa to - 2547******743 DENNIS WAMURANGA,Completed,,-2000.0,33.0
SKS9FL2NTT,2024-11-28 14:03:00.029,OverDraft of Credit Party,Completed,1746.71,,2033.0
SKR9DEKFY3,2024-11-27 21:20:00.010,OD Loan Repayment to 232323 - M-PESA Overdraw,Completed,,-388.71,286.29
SKR0DEK8M8,2024-11-27 21:20:00.010,Funds received from - 07******576 WARUGURU IDDA,Completed,675.0,,675.0
SKQ76S21UF,2024-11-26 13:34:00.019,,Completed,,-674.0,0.0
SKQ66S272G,2024-11-26 13:34:00.019,,Completed,674.0,,674.0
SKP2403KTQ,2024-11-25 18:47:00.010,,Completed,,-15.0,0.0
SKP2403KTQ,2024-11-25 18:47:00.010,,Completed,,-1400.0,15.0
SKP2403KTQ,2024-11-25 18:47:00.010,of Credit Party,Completed,1049.21,,1415.0
SKP33ZTRLN,2024-11-25 18:45:59.962,,Completed,,-612.21,365.79
SKP43ZTNSQ,2024-11-25 18:45:59.962,,Completed,978.0,,978.0
SKP43K9HD2,2024-11-25 17:24:59.962,,Completed,,-50.0,0.0
SKP43K9HD2,2024-11-25 17:24:59.962,of Credit Party,Completed,50.0,,50.0
SKP4343S9M,2024-11-25 15:38:59.971,,Completed,,-33.0,0.0
SKP4343S9M,2024-11-25 15:38:59.971,,Completed,,-2100.0,33.0
SKP4343S9M,2024-11-25 15:38:59.971,of Credit Party,Completed,556.14,,2133.0
SKP82R0OIC,2024-11-25 14:05:00.038,,Completed,,-60.0,1576.86
SKP02OW3ZE,2024-11-25 13:50:00.010,,Completed,,-390.0,1636.86
SKP12JRDWN,2024-11-25 13:14:59.971,,Completed,,-1000.0,2026.86
SKO8Y06I8M,2024-11-24 14:57:59.990,,Completed,,-500.0,3026.86
SKO7XTSNG3,2024-11-24 14:12:59.990,,Completed,,-2948.0,3526.86
SKN5VW1C63,2024-11-23 21:26:00.038,,Completed,,-33.0,6474.86
SKN5VW1C63,2024-11-23 21:26:00.038,,Completed,,-2500.0,6507.86
SKN5UZ37HN,2024-11-23 18:42:59.990,,Completed,,-7.0,9007.86
SKN5UZ37HN,2024-11-23 18:42:59.990,,Completed,,-400.0,9014.86
SKN6U9DNSI,2024-11-23 16:21:59.962,,Completed,,-50.0,9414.86
SKN8U3XO8K,2024-11-23 15:45:59.962,,Completed,,-535.14,9464.86
SKN3U3XM37,2024-11-23 15:45:59.962,,Completed,10000.0,,10000.0
SKM2R05988,2024-11-22 19:32:00.010,,Completed,,-210.0,0.0
SKM2R05988,2024-11-22 19:32:00.010,of Credit Party,Completed,210.0,,210.0
SKM2QWSZ88,2024-11-22 19:18:00.029,,Completed,401.0,,401.0
SKM8QWT6TQ,2024-11-22 19:18:00.029,,Completed,,-401.0,0.0
SKM4QV2U3M,2024-11-22 19:09:59.990,,Completed,,-25.0,0.0
SKM4QV2U3M,2024-11-22 19:09:59.990,of Credit Party,Completed,25.0,,25.0
SKM1QS08NL,2024-11-22 18:58:00.019,,Completed,,-33.0,0.0
SKM1QS08NL,2024-11-22 18:58:00.019,,Completed,,-1700.0,33.0
SKM1QS08NL,2024-11-22 18:58:00.019,of Credit Party,Completed,691.87,,1733.0
SKM6P4LXPS,2024-11-22 13:03:59.962,,Completed,,-200.0,1041.13
SKM9OG1IA5,2024-11-22 10:00:59.990,,Completed,,-23.0,1241.13
SKM9OG1IA5,2024-11-22 10:00:59.990,,Completed,,-1083.0,1264.13
SKL4LGN3A6,2024-11-21 15:06:59.990,,Completed,,-30.0,2347.13
SKK2GO24NS,2024-11-20 12:15:59.990,,Completed,,-33.0,2377.13
SKK2GO24NS,2024-11-20 12:15:59.990,,Completed,,-1530.0,2410.13
SKK0GM2W30,2024-11-20 12:00:59.962,,Completed,,-34.0,3940.13
SKK0GM2W30,2024-11-20 00:00:00.000,,Completed,,-3600.0,3974.13
SKK9GLJDTL,2024-11-20 00:00:00.000,,Completed,,-25.0,7574.13
SKK9GLJDTL,2024-11-20 00:00:00.000,,Completed,,-2850.0,7599.13
SKI18KQKYN,2024-11-18 00:00:00.000,,Completed,,-78.0,10449.13
SKI18KQKYN,2024-11-18 00:00:00.000,,Completed,,-7500.0,10527.13
SKI28K3YT8,2024-11-18 00:00:00.000,,Completed,,-1972.87,18027.13
SKI78K3WHR,2024-11-18 00:00:00.000,,Completed,20000.0,,20000.0
SKG035YS46,2024-11-16 00:00:00.000,,Completed,,-7.0,0.0
SKG035YS46,2024-11-16 00:00:00.000,,Completed,,-400.0,7.0
SKG035YS46,2024-11-16 00:00:00.000,of Credit,Completed,407.0,,407.0
SKF7WW5LPR,2024-11-15 00:00:00.000,,Completed,,-50.0,0.0
SKF7WW5LPR,2024-11-15 00:00:00.000,of Credit,Completed,50.0,,50.0
SKF6WV7AKG,2024-11-15 00:00:00.000,,Completed,,-290.0,0.0
SKF6WV7AKG,2024-11-15 00:00:00.000,of Credit,Completed,290.0,,290.0
SKF4VJY18Q,2024-11-15 00:00:00.000,,Completed,,-11.0,0.0
SKF4VJY18Q,2024-11-15 00:00:00.000,,Completed,,-2000.0,11.0
SKF4VJY18Q,2024-11-15 00:00:00.000,of Credit,Completed,1163.56,,2011.0
SKF8U7N5RQ,2024-11-15 00:00:00.000,,Completed,,-7.0,847.44
SKF8U7N5RQ,2024-11-15 00:00:00.000,,Completed,,-350.0,854.44
SKE9SWBHIX,2024-11-14 00:00:00.000,,Completed,,-7.0,1204.44
SKE9SWBHIX,2024-11-14 00:00:00.000,,Completed,,-470.0,1211.44
SKE0SW05WS,2024-11-14 00:00:00.000,,Completed,,-7.0,1681.44
SKE0SW05WS,2024-11-14 00:00:00.000,,Completed,,-450.0,1688.44
SKE4SUZKUQ,2024-11-14 00:00:00.000,,Completed,,-100.0,2138.44
SKE3SUN1GP,2024-11-14 00:00:00.000,,Completed,,-7.0,2238.44
SKE3SUN1GP,2024-11-14 00:00:00.000,,Completed,,-340.0,2245.44
SKE3SQX10F,2024-11-14 00:00:00.000,,Completed,,-7.0,2585.44
SKE3SQX10F,2024-11-14 00:00:00.000,,Completed,,-180.0,2592.44
SKE1SKTJWX,2024-11-14 00:00:00.000,,Completed,,-227.56,2772.44
SKE5SKTFBH,2024-11-14 00:00:00.000,,Completed,3000.0,,3000.0
SKE5SKPY67,2024-11-14 00:00:00.000,,Completed,0.0,,0.0
SKE2SK8ZII,2024-11-14 00:00:00.000,,Completed,,-1104.0,0.0
SKE0SK9AIU,2024-11-14 00:00:00.000,,Completed,1104.0,,1104.0
SKE2QPZ2QS,2024-11-14 00:00:00.000,,Completed,,-200.0,0.0
SKE2QPZ2QS,2024-11-14 00:00:00.000,of Credit,Completed,200.0,,200.0
SKE4Q8CAG2,2024-11-14 00:00:00.000,,Completed,,-57.0,0.0
SKE4Q8CAG2,2024-11-14 00:00:00.000,,Completed,,-4000.0,57.0
SKE4Q8CAG2,2024-11-14 00:00:00.000,of Credit,Completed,1118.37,,4057.0
SKD3OSBVK9,2024-11-13 00:00:00.000,,Completed,,-61.37,2938.63
SKD0OSC23G,2024-11-13 00:00:00.000,,Completed,3000.0,,3000.0
SKC7KGGWY9,2024-11-12 00:00:00.000,,Completed,,-290.0,0.0
SKC7KGGWY9,2024-11-12 00:00:00.000,of Credit,Completed,60.76,,290.0
SKC0KDCXXO,2024-11-12 00:00:00.000,,Completed,,-2153.0,229.24
SKC8K74084,2024-11-12 00:00:00.000,,Completed,2000.0,,2382.24
SKC8K6UD8Q,2024-11-12 00:00:00.000,,Completed,,-700.0,382.24
SKA2CLLESG,2024-11-10 00:00:00.000,,Completed,,-7.0,1082.24
SKA2CLLESG,2024-11-10 00:00:00.000,,Completed,,-250.0,1089.24
SK9381070H,2024-11-09 00:00:00.000,,Completed,,-50.0,1339.24
SK927ZTSD0,2024-11-09 00:00:00.000,,Completed,,-40.0,1389.24
SK927Y0V28,2024-11-09 00:00:00.000,,Completed,,-1250.0,1429.24
SK907BMC2G,2024-11-09 00:00:00.000,,Completed,2000.0,,2679.24
SK9679DCC8,2024-11-09 00:00:00.000,,Completed,,-10.0,679.24
SK9679DCC8,2024-11-09 00:00:00.000,,Completed,,-570.0,689.24
SK9178Y0D9,2024-11-09 00:00:00.000,,Completed,,-1740.76,1259.24
SK9478XYWK,2024-11-09 00:00:00.000,,Completed,3000.0,,3000.0
SK853MC931,2024-11-08 00:00:00.000,,Completed,,-420.0,0.0
SK853MC931,2024-11-08 00:00:00.000,of Credit,Completed,420.0,,420.0
SK853M1B1R,2024-11-08 00:00:00.000,,Completed,,-370.0,0.0
SK853M1B1R,2024-11-08 00:00:00.000,of Credit,Completed,370.0,,370.0
SK893K318T,2024-11-08 00:00:00.000,,Completed,,-60.0,0.0
SK893K318T,2024-11-08 00:00:00.000,of Credit,Completed,60.0,,60.0
SK893I7W8B,2024-11-08 00:00:00.000,,Completed,,-7.0,0.0
SK893I7W8B,2024-11-08 00:00:00.000,,Completed,,-150.0,7.0
SK893I7W8B,2024-11-08 00:00:00.000,of Credit,Completed,157.0,,157.0
SK873HAD7H,2024-11-08 00:00:00.000,,Completed,,-100.0,0.0
SK873HAD7H,2024-11-08 00:00:00.000,of Credit,Completed,100.0,,100.0
SK843H3IBW,2024-11-08 00:00:00.000,,Completed,,-7.0,0.0
SK843H3IBW,2024-11-08 00:00:00.000,,Completed,,-245.0,7.0
SK843H3IBW,2024-11-08 00:00:00.000,of Credit,Completed,252.0,,252.0
SK813F0XEB,2024-11-08 00:00:00.000,,Completed,,-7.0,0.0
SK813F0XEB,2024-11-08 00:00:00.000,,Completed,,-170.0,7.0
SK813F0XEB,2024-11-08 00:00:00.000,of Credit,Completed,177.0,,177.0
SK61SMAUSX,2024-11-06 00:00:00.000,,Completed,,-200.0,0.0
SK61SMAUSX,2024-11-06 00:00:00.000,of Credit,Completed,187.52,,200.0
SK56O8LWMO,2024-11-05 00:00:00.000,,Completed,,-10.0,12.48
SK56O8LWMO,2024-11-05 00:00:00.000,,Completed,,-1000.0,22.48
SK59O85CA5,2024-11-05 00:00:00.000,,Completed,1500.0,,1500.0
SK59O85CAP,2024-11-05 00:00:00.000,,Completed,,-477.52,1022.48
SK48L6UT4S,2024-11-04 00:00:00.000,,Completed,,-1400.0,0.0
SK48L6UT4S,2024-11-04 19:14:00.010,of Credit Party,Completed,472.79,,1400.0
SK47L4BYPR,2024-11-04 19:03:59.962,,Completed,,-60.0,927.21
SK40L3AC0E,2024-11-04 19:00:00.029,,Completed,,-100.0,987.21
SK41L2RR81,2024-11-04 18:56:59.971,,Completed,,-100.0,1087.21
SK43L1UYNT,2024-11-04 18:54:00.000,,Completed,,-40.0,1187.21
SK45L1F1W5,2024-11-04 18:51:59.990,,Completed,,-50.0,1227.21
SK41L0XGYH,2024-11-04 18:49:59.981,,Completed,,-100.0,1277.21
SK48KX250I,2024-11-04 18:33:59.990,,Completed,1000.0,,1377.21
SK42IT4YK2,2024-11-04 10:25:00.019,,Completed,1400.0,,1400.0
SK45IT4PMH,2024-11-04 10:25:00.019,,Completed,,-1022.79,377.21
SK40IT0MDI,2024-11-04 10:23:59.971,,Completed,,-42.0,0.0
SK40IT0MDI,2024-11-04 10:23:59.971,,Completed,,-5010.0,42.0
SK40IT0MDI,2024-11-04 10:23:59.971,of Credit Party,Completed,1012.66,,5052.0
SK41ISTCO5,2024-11-04 10:23:00.010,,Completed,,-42.0,4039.34
SK41ISTCO5,2024-11-04 10:23:00.010,,Completed,,-6000.0,4081.34
SK48ISNYKA,2024-11-04 10:21:59.962,,Completed,6000.0,,10081.34
SK41IP801J,2024-11-04 09:56:00.010,,Completed,782.0,,4081.34
SK26BZH3WI,2024-11-02 16:47:00.038,,Completed,,-13.0,3299.34
SK26BZH3WI,2024-11-02 16:47:00.038,,Completed,,-600.0,3312.34
SK27AO1QOH,2024-11-02 11:37:59.981,,Completed,,-20.0,3912.34
SK27AO1QOH,2024-11-02 11:37:59.981,,Completed,,-2500.0,3932.34
SK138EJXPJ,2024-11-01 19:09:00.029,,Completed,,-25.0,6432.34
SK138EJXPJ,2024-11-01 19:09:00.029,,Completed,,-3250.0,6457.34
SK148EEGQG,2024-11-01 19:07:59.981,,Completed,,-292.66,9707.34
SK158EEC7Z,2024-11-01 19:07:59.981,,Completed,10000.0,,10000.0
SJV63YZKUO,2024-10-31 18:58:00.019,,Completed,,-710.0,0.0
SJV63YZKUO,2024-10-31 18:58:00.019,of Credit Party,Completed,289.76,,710.0
SJV83UYBBY,2024-10-31 18:40:59.981,,Completed,,-170.0,427.24
SJV32N4L2V,2024-10-31 14:12:00.029,,Completed,,-200.0,597.24
SJS0Q5ZEDW,2024-10-28 18:51:59.990,,Completed,,-53.0,0.0
SJS0Q5ZEDW,2024-10-28 18:51:59.990,,Completed,,-3000.0,53.0
SJS0Q5ZEDW,2024-10-28 18:51:59.990,of Credit Party,Completed,1069.06,,3053.0
SJS0OQF3CK,2024-10-28 13:36:00.029,,Completed,,-7.0,483.94
SJS0OQF3CK,2024-10-28 13:36:00.029,,Completed,,-150.0,490.94
SJS3OPJUL9,2024-10-28 13:30:59.962,,Completed,,-40.0,640.94
SJS4OOXQZC,2024-10-28 13:25:59.981,,Completed,,-7.0,680.94
SJS4OOXQZC,2024-10-28 13:25:59.981,,Completed,,-250.0,687.94
SJS9OOT6HT,2024-10-28 13:25:59.981,,Completed,,-13.0,937.94
SJS9OOT6HT,2024-10-28 00:00:00.000,Customer Transfer to - 2547******315 FRANCIS MWANGI,Completed,,-780.0,950.94
SJS6OMMRZQ,2024-10-28 00:00:00.000,Customer Transfer of Funds Charge,Completed,,-7.0,1730.94
SJS6OMMRZQ,2024-10-28 00:00:00.000,Customer Transfer to - 2547******590 NICHOLAS NYELELE,Completed,,-150.0,1737.94
SJS1OMDTM1,2024-10-28 00:00:00.000,Customer Transfer of Funds Charge,Completed,,-7.0,1887.94
SJS1OMDTM1,2024-10-28 00:00:00.000,Customer Transfer to - 2547******565 EUCABETH NYAKWEBA,Completed,,-500.0,1894.94
SJS5OM0VUX,2024-10-28 00:00:00.000,Customer Transfer of Funds Charge,Completed,,-7.0,2394.94
SJS5OM0VUX,2024-10-28 00:00:00.000,Customer Transfer to - 2547******115 EUCABETH NYAKWEBA,Completed,,-120.0,2401.94
SJS7OKGK1B,2024-10-28 00:00:00.000,Merchant Payment Online to 7071544 - ROYAL NEST SPICES AND HERBS,Completed,,-100.0,2521.94
SJS7OFFLBL,2024-10-28 00:00:00.000,Transfer from Bank 517819 - IM BANK LIMITED- APP to Customer via API,Completed,1500.0,,2621.94
SJR6L8MKSC,2024-10-27 00:00:00.000,Airtime Purchase,Completed,,-50.0,1121.94
SJP4E3703W,2024-10-25 00:00:00.000,Customer Transfer of Funds Charge,Completed,,-7.0,1171.94
SJP4E3703W,2024-10-25 00:00:00.000,Customer Transfer to - 2547******750 LUCY GATHIMBA,Completed,,-270.0,1178.94
SJP1BITA8Z,2024-10-25 00:00:00.000,Customer Transfer of Funds Charge,Completed,,-13.0,1448.94
SJP1BITA8Z,2024-10-25 00:00:00.000,Customer Transfer to - 01******452 NAncy okoth,Completed,,-800.0,1461.94
SJP7BIMDMB,2024-10-25 00:00:00.000,Pay Bill Online to 200200 - Safaricom Post Paid Acc. 0729920461,Completed,,-1000.0,2261.94
SJP1BIDLWB,2024-10-25 00:00:00.000,Funds received from - 2547******326 OMONDI LOVELL,Completed,3000.0,,3261.94
SJO78VCCF9,2024-10-24 00:00:00.000,Pay Merchant Charge,Completed,,-2.2,261.94
SJO78VCCF9,2024-10-24 00:00:00.000,"Merchant Payment Online to 7082014 - TOTALENERGIES ABC
2",Completed,,-400.0,264.14
SJN73UWX45,2024-10-23 00:00:00.000,Merchant Payment Online to 6900165 -             ALONG MAGOK MAJOK DHOR,Completed,,-450.0,664.14
SJN73TW8U5,2024-10-23 00:00:00.000,Customer Transfer of Funds Charge,Completed,,-7.0,1114.14
SJN73TW8U5,2024-10-23 00:00:00.000,Customer Payment to Small Business to - 2547******655 JANE MWORIA,Completed,,-160.0,1121.14
SJN43RMK2U,2024-10-23 00:00:00.000,Merchant Payment Online to 491847 -            JANDEE GENERAL STORES,Completed,,-50.0,1281.14
SJN23QOFJ0,2024-10-23 00:00:00.000,OD Loan Repayment to 232323 - M-PESA Overdraw,Completed,,-668.86,1331.14
SJN73QO6M1,2024-10-23 00:00:00.000,Transfer from Bank 517819 - IM BANK LIMITED- APP to Customer via API,Completed,2000.0,,2000.0
SJN33QHOPN,2024-10-23 00:00:00.000,Merchant Payment Fuliza M-Pesa Online to 893481 - AAR Rongai Out Patient Centre,Completed,,-700.0,0.0
SJN33QHOPN,2024-10-23 00:00:00.000,OverDraft of Credit Party,Completed,662.23,,700.0
SJM51VAQKR,2024-10-22 00:00:00.000,Airtime Purchase,Completed,,-20.0,37.77
SJM51ISSM3,2024-10-22 00:00:00.000,Airtime Purchase,Completed,,-20.0,57.77
SJL1UB1CR5,2024-10-21 00:00:00.000,Customer Transfer of Funds Charge,Completed,,-23.0,77.77
SJL1UB1CR5,2024-10-21 00:00:00.000,Customer Transfer to - 2547******808 HADLISTONE OMURALO,Completed,,-1030.0,100.77
SJJ1LSH91P,2024-10-19 00:00:00.000,Pay Bill Charge,Completed,,-34.0,1130.77
SJJ1LSH91P,2024-10-19 00:00:00.000,Pay Bill Online to 880100 - NCBA BANK KENYA PLC. Acc. 100618,Completed,,-4085.0,1164.77
SJJ9LSAJS3,2024-10-19 00:00:00.000,Transfer from Bank 517819 - IM BANK LIMITED- APP to Customer via API,Completed,5000.0,,5249.77
SJI9I5KPUB,2024-10-18 00:00:00.000,Customer Transfer of Funds Charge,Completed,,-13.0,249.77
SJI9I5KPUB,2024-10-18 00:00:00.000,Customer Transfer to - 2547******090 VIOLET JEPCHIRCHIR,Completed,,-800.0,262.77
SJH5FH201F,2024-10-17 00:00:00.000,Customer Transfer to - 07******181 SAMSON RATUNKA,Completed,,-50.0,1062.77
SJH5FF5XRP,2024-10-17 00:00:00.000,Customer Transfer to - 07******006 dickson rodgers,Completed,,-100.0,1112.77
SJH1F6GX2J,2024-10-17 16:36:59.990,,Completed,,-50.0,1212.77
SJH6F3X3EI,2024-10-17 16:20:00.038,,Completed,,-197.23,1262.77
SJH4F3X1VQ,2024-10-17 16:20:00.038,,Completed,1460.0,,1460.0
SJH2F2VDHO,2024-10-17 16:12:00.000,,Completed,,-3320.0,0.0
SJH2F2VDHO,2024-10-17 16:12:00.000,of Credit Party,Completed,195.27,,3320.0
SJH5F2QJ3Z,2024-10-17 16:11:00.038,,Completed,,-875.27,3124.73
SJH1F2QCH9,2024-10-17 16:11:00.038,,Completed,4000.0,,4000.0
SJH4EQ4JBA,2024-10-17 14:37:59.981,,Completed,,-20.0,0.0
SJH4EQ4JBA,2024-10-17 14:37:59.981,,Completed,,-2500.0,20.0
SJH4EQ4JBA,2024-10-17 14:37:59.981,of Credit Party,Completed,866.6,,2520.0
SJH4EMVYOE,2024-10-17 14:14:00.038,,Completed,,-48.0,1653.4
SJH4EMVYOE,2024-10-17 14:14:00.038,,Completed,,-8000.0,1701.4
SJH9EMOXAL,2024-10-17 14:12:00.029,,Completed,8000.0,,9701.4
SJH3EHWDUR,2024-10-17 13:38:00.038,,Completed,,-7.0,1701.4
SJH3EHWDUR,2024-10-17 13:38:00.038,,Completed,,-350.0,1708.4
SJH2E83QW4,2024-10-17 12:27:00.000,,Completed,,-7.0,2058.4
SJH2E83QW4,2024-10-17 12:27:00.000,,Completed,,-350.0,2065.4
SJG4B8YBFK,2024-10-16 17:03:00.029,,Completed,,-70.0,2415.4
SJG0B7HW7G,2024-10-16 16:54:00.029,,Completed,,-50.0,2485.4
SJG4B71FJQ,2024-10-16 16:50:59.971,,Completed,,-1250.0,2535.4
SJG8B5WKHS,2024-10-16 16:43:00.019,,Completed,,-7.0,3785.4
SJG8B5WKHS,2024-10-16 16:43:00.019,,Completed,,-400.0,3792.4
SJG99ZG1SP,2024-10-16 11:28:00.019,,Completed,,-103.0,4192.4
SJG99ZG1SP,2024-10-16 11:28:00.019,,Completed,,-45000.0,4295.4
SJF98EH7VH,2024-10-15 20:39:00.029,,Completed,,-704.6,49295.4
SJF88EH3GK,2024-10-15 20:39:00.029,,Completed,50000.0,,50000.0
SJE64CCIKU,2024-10-14 20:53:59.971,,Completed,,-20.0,0.0
SJE64CCIKU,2024-10-14 20:53:59.971,,Completed,,-1920.0,20.0
SJE64CCIKU,2024-10-14 20:53:59.971,of Credit Party,Completed,697.62,,1940.0
SJE444OXM2,2024-10-14 20:10:00.019,,Completed,,-13.0,1242.38
SJE444OXM2,2024-10-14 20:10:00.019,,Completed,,-700.0,1255.38
SJE93HRL4R,2024-10-14 18:27:00.000,,Completed,,-100.0,1955.38
SJE33G2E6R,2024-10-14 18:18:00.000,,Completed,1000.0,,2055.38
SJE13FWOE3,2024-10-14 18:17:00.038,,Completed,,-1944.62,1055.38
SJE13FWM3V,2024-10-14 18:17:00.038,,Completed,3000.0,,3000.0
SJE927U8TX,2024-10-14 13:21:00.000,,Completed,,-30.0,0.0
SJE927U8TX,2024-10-14 13:21:00.000,of Credit Party,Completed,30.0,,30.0
SJE226JG72,2024-10-14 13:11:00.038,,Completed,,-7.0,0.0
SJE226JG72,2024-10-14 13:11:00.038,,Completed,,-200.0,7.0
SJE226JG72,2024-10-14 13:11:00.038,of Credit Party,Completed,207.0,,207.0
SJE926FUVP,2024-10-14 13:11:00.038,,Completed,,-7.0,0.0
SJE926FUVP,2024-10-14 13:11:00.038,,Completed,,-400.0,7.0
SJE926FUVP,2024-10-14 13:11:00.038,of Credit Party,Completed,407.0,,407.0
SJE2251IQA,2024-10-14 13:00:59.990,,Completed,,-33.0,0.0
SJE2251IQA,2024-10-14 13:00:59.990,,Completed,,-2000.0,33.0
SJE2251IQA,2024-10-14 13:00:59.990,of Credit Party,Completed,1281.36,,2033.0
SJE32340B3,2024-10-14 12:45:59.962,,Completed,,-53.0,751.64
SJE32340B3,2024-10-14 12:45:59.962,,Completed,,-3000.0,804.64
SJE01PX0KQ,2024-10-14 11:03:59.990,,Completed,4500.0,,4500.0
SJE61PXD7W,2024-10-14 11:03:59.990,,Completed,,-695.36,3804.64
SJB5R6RTVF,2024-10-11 20:24:59.962,,Completed,,-100.0,0.0
SJB5R6RTVF,2024-10-11 20:24:59.962,of Credit Party,Completed,100.0,,100.0
SJB9R5GX5D,2024-10-11 20:17:59.971,,Completed,,-718.0,0.0
SJB9R5GX5D,2024-10-11 20:17:59.971,of Credit Party,Completed,588.47,,718.0
SJB4R1KI4E,2024-10-11 19:57:59.962,,Completed,,-40.0,129.53
SJB5R0R55L,2024-10-11 19:54:00.029,,Completed,,-10.0,169.53
SJB2QYFR1E,2024-10-11 19:43:00.019,,Completed,,-2000.0,179.53
SJB7QYD1PN,2024-10-11 19:43:00.019,,Completed,1000.0,,2179.53
SJB4PPPM02,2024-10-11 15:47:00.010,,Completed,,-5100.0,1179.53
SJB8PPMNKS,2024-10-11 15:45:59.962,,Completed,6000.0,,6279.53
SJB8PER0LG,2024-10-11 14:28:00.019,,Completed,,-34.0,279.53
SJB8PER0LG,2024-10-11 14:28:00.019,,Completed,,-4000.0,313.53
SJB3P1T4GN,2024-10-11 12:58:00.019,,Completed,,-13.0,4313.53
SJB3P1T4GN,2024-10-11 12:58:00.019,,Completed,,-650.0,4326.53
SJB1P1CQLB,2024-10-11 12:54:00.000,,Completed,,-23.47,4976.53
SJB7P1CRXT,2024-10-11 12:54:00.000,,Completed,5000.0,,5000.0
SJA0KTUXP8,2024-10-10 12:24:00.029,,Completed,,-34.0,0.0
SJA0KTUXP8,2024-10-10 12:24:00.029,,Completed,,-3859.0,34.0
SJA0KTUXP8,2024-10-10 12:24:00.029,of Credit Party,Completed,23.23,,3893.0
SJA5KTP2JF,2024-10-10 12:22:59.981,,Completed,,-34.0,3869.77
SJA5KTP2JF,2024-10-10 12:22:59.981,,Completed,,-3859.0,3903.77
SJA3KQ5Y7V,2024-10-10 11:55:59.981,,Completed,,-18.0,7762.77
SJA3KQ5Y7V,2024-10-10 11:55:59.981,,Completed,,-10000.0,7780.77
SJA2KPY53A,2024-10-10 11:55:00.019,,Completed,,-48.0,17780.77
SJA2KPY53A,2024-10-10 11:55:00.019,,Completed,,-8500.0,17828.77
SJA7KPJ1DT,2024-10-10 11:51:00.000,,Completed,,-1671.23,26328.77
SJA3KPJBPN,2024-10-10 11:51:00.000,,Completed,28000.0,,28000.0
SJ90HKJVWQ,2024-10-09 16:07:00.019,,Completed,,-7.0,0.0
SJ90HKJVWQ,2024-10-09 16:07:00.019,,Completed,,-120.0,7.0
SJ90HKJVWQ,2024-10-09 16:07:00.019,of Credit Party,Completed,127.0,,127.0
SJ82CEHSOM,2024-10-08 11:24:59.962,,Completed,,-200.0,0.0
SJ82CEHSOM,2024-10-08 11:24:59.962,of Credit Party,Completed,200.0,,200.0
SJ70AAKJT2,2024-10-07 19:07:59.981,,Completed,,-135.0,0.0
SJ70AAKJT2,2024-10-07 19:07:59.981,of Credit Party,Completed,135.0,,135.0
SJ71A9MIN9,2024-10-07 19:03:59.962,,Completed,,-50.0,0.0
SJ71A9MIN9,2024-10-07 19:03:59.962,of Credit Party,Completed,50.0,,50.0
SJ74A7CBHW,2024-10-07 18:54:00.000,,Completed,,-1846.0,0.0
SJ74A7CBHW,2024-10-07 18:54:00.000,of Credit Party,Completed,1099.91,,1846.0
SJ70A6U5A4,2024-10-07 18:51:59.990,,Completed,,-53.91,746.09
SJ79A6UEY5,2024-10-07 18:51:59.990,,Completed,800.0,,800.0
SJ542NN6CI,2024-10-05 20:53:00.010,,Completed,,-50.0,0.0
SJ542NN6CI,2024-10-05 20:53:00.010,of Credit Party,Completed,50.0,,50.0
SJ562MST32,2024-10-05 20:48:59.990,,Completed,,-13.0,0.0
SJ562MST32,2024-10-05 20:48:59.990,,Completed,,-900.0,13.0
SJ562MST32,2024-10-05 20:48:59.990,of Credit Party,Completed,3.37,,913.0
SJ57287915,2024-10-05 19:39:59.962,,Completed,,-78.0,909.63
SJ57287915,2024-10-05 19:39:59.962,,Completed,,-5100.0,987.63
SJ5527Y7BJ,2024-10-05 19:39:00.000,,Completed,,-748.37,6087.63
SJ5327XAUV,2024-10-05 19:39:00.000,,Completed,6836.0,,6836.0
SJ591Y10AX,2024-10-05 19:00:00.029,,Completed,,-5.0,0.0
SJ591Y10AX,2024-10-05 19:00:00.029,,Completed,,-400.0,5.0
SJ591Y10AX,2024-10-05 19:00:00.029,of Credit Party,Completed,405.0,,405.0
SJ581V29IW,2024-10-05 18:47:59.971,,Completed,,-1300.0,0.0
SJ581V29IW,2024-10-05 18:47:59.971,of Credit Party,Completed,335.96,,1300.0
SJ55ZDAYIF,2024-10-05 13:34:59.981,,Completed,,-1400.0,964.04
SJ51ZAEZYD,2024-10-05 13:16:00.019,,Completed,,-13.0,2364.04
SJ51ZAEZYD,2024-10-05 13:16:00.019,,Completed,,-600.0,2377.04
SJ54Z0AZ2W,2024-10-05 12:06:59.990,,Completed,,-100.0,2977.04
SJ59YXMVM7,2024-10-05 11:48:00.029,,Completed,,-280.0,3077.04
SJ45X7ILER,2024-10-04 20:53:59.971,,Completed,,-50.0,3357.04
SJ45X3AAIL,2024-10-04 20:30:59.990,,Completed,,-1600.0,3407.04
SJ43WRW7KF,2024-10-04 19:36:59.990,,Completed,,-500.0,5007.04
SJ47WR3FK5,2024-10-04 19:34:00.019,,Completed,,-80.0,5507.04
SJ48WPBNWU,2024-10-04 19:27:00.029,,Completed,,-60.0,5587.04
SJ42WN8MCA,2024-10-04 19:18:00.029,,Completed,,-13.0,5647.04
SJ42WN8MCA,2024-10-04 19:18:00.029,,Completed,,-600.0,5660.04
SJ44UDPXV2,2024-10-04 10:43:59.981,Charge,Completed,,-42.0,6260.04
SJ44UDPXV2,2024-10-04 10:43:59.981,,Completed,,-5010.0,6302.04
SJ48UDFL3G,2024-10-04 10:41:59.971,Charge,Completed,,-42.0,11312.04
SJ48UDFL3G,2024-10-04 10:41:59.971,,Completed,,-6000.0,11354.04
SJ47TW4B4H,2024-10-04 08:26:59.971,,Completed,15000.0,,17354.04
SJ32SP4Z3M,2024-10-03 20:14:00.038,Charge,Completed,,-10.0,2354.04
SJ32SP4Z3M,2024-10-03 20:14:00.038,,Completed,,-1000.0,2364.04
SJ26O3PCRA,2024-10-02 19:18:59.990,,Completed,,-7.0,3364.04
SJ26O3PCRA,2024-10-02 19:18:59.990,,Completed,,-400.0,3371.04
SJ28O1SL7W,2024-10-02 19:12:00.000,,Completed,,-7.0,3771.04
SJ28O1SL7W,2024-10-02 19:12:00.000,,Completed,,-115.0,3778.04
SJ22O0SYLU,2024-10-02 19:07:59.981,,Completed,,-7.0,3893.04
SJ22O0SYLU,2024-10-02 19:07:59.981,,Completed,,-300.0,3900.04
SJ24NZOMAU,2024-10-02 19:03:00.000,,Completed,,-7.0,4200.04
SJ24NZOMAU,2024-10-02 19:03:00.000,,Completed,,-120.0,4207.04
SJ20NY458G,2024-10-02 18:56:59.971,,Completed,,-100.0,4327.04
SJ24N1PPU0,2024-10-02 15:58:00.019,,Completed,,-23.0,4427.04
SJ24N1PPU0,2024-10-02 15:58:00.019,,Completed,,-1300.0,4450.04
SJ24MDZ4R8,2024-10-02 13:11:00.038,,Completed,,-200.0,5750.04
SIU8DNOT90,2024-09-30 11:50:00.038,Charge,Completed,,-5.0,5950.04
SIU8DNOT90,2024-09-30 11:50:00.038,,Completed,,-200.0,5955.04
SIU5DM5PA5,2024-09-30 11:37:59.981,,Completed,,-1020.0,6155.04
SIU6DKW5DI,2024-09-30 11:28:00.019,,Completed,,-1023.0,7175.04
SIU5DI4O83,2024-09-30 11:06:59.962,,Completed,,-480.0,8198.04
SIT9C64NIV,2024-09-29 21:20:00.010,Charge,Completed,,-20.0,8678.04
SIT9C64NIV,2024-09-29 21:20:00.010,,Completed,,-1750.0,8698.04
SIT7BEUQQ5,2024-09-29 18:38:59.971,,Completed,,-13.0,10448.04
SIT7BEUQQ5,2024-09-29 18:38:59.971,,Completed,,-1000.0,10461.04
SIT2B7E3NY,2024-09-29 17:59:00.038,Charge,Completed,,-5.0,11461.04
SIT2B7E3NY,2024-09-29 17:59:00.038,,Completed,,-257.0,11466.04
SIT0AHAY4U,2024-09-29 15:06:59.990,,Completed,,-5900.0,11723.04
SIT8AH5IO4,2024-09-29 15:06:00.029,,Completed,10000.0,,17623.04
SIT5ACCLHN,2024-09-29 14:32:00.038,Charge,Completed,,-20.0,7623.04
SIT5ACCLHN,2024-09-29 14:32:00.038,,Completed,,-2000.0,7643.04
SIT1AATJ2B,2024-09-29 14:21:00.029,Charge,Completed,,-15.0,9643.04
SIT1AATJ2B,2024-09-29 14:21:00.029,,Completed,,-1500.0,9658.04
SIT9A0SQR3,2024-09-29 13:09:00.029,Charge,Completed,,-10.0,11158.04
SIT9A0SQR3,2024-09-29 13:09:00.029,,Completed,,-650.0,11168.04
SIT2A0NY4G,2024-09-29 13:07:59.981,,Completed,,-200.0,11818.04
SIT79TRYKX,2024-09-29 12:13:00.019,,Completed,12477.0,,12477.0
SIT79TS7UT,2024-09-29 12:13:00.019,,Completed,,-458.96,12018.04
SIR92BQ2VH,2024-09-27 15:45:00.000,,Completed,,-200.0,0.0
SIR92BQ2VH,2024-09-27 15:45:00.000,of Credit Party,Completed,200.0,,200.0
SIQ4WFYI3W,2024-09-26 12:40:00.019,,Completed,,-30.0,0.0
SIQ4WFYI3W,2024-09-26 12:40:00.019,of Credit Party,Completed,30.0,,30.0
SIQ6WFX6V4,2024-09-26 12:40:00.019,,Completed,,-13.0,0.0
SIQ6WFX6V4,2024-09-26 12:40:00.019,,Completed,,-1000.0,13.0
SIQ6WFX6V4,2024-09-26 12:40:00.019,of Credit Party,Completed,224.41,,1013.0
SIQ0W8N9BC,2024-09-26 11:42:59.962,,Completed,,-686.41,788.59
SIQ7W8MSAR,2024-09-26 11:42:59.962,,Completed,1475.0,,1475.0
SIO0OOGTXE,2024-09-24 13:20:00.038,,Completed,,-7.0,0.0
SIO0OOGTXE,2024-09-24 13:20:00.038,,Completed,,-150.0,7.0
SIO0OOGTXE,2024-09-24 13:20:00.038,of Credit Party,Completed,157.0,,157.0
SIO5ONIFW3,2024-09-24 13:12:59.962,,Completed,,-80.0,0.0
SIO5ONIFW3,2024-09-24 13:12:59.962,of Credit Party,Completed,80.0,,80.0
SIO5OMYPT1,2024-09-24 13:09:00.029,,Completed,,-13.0,0.0
SIO5OMYPT1,2024-09-24 13:09:00.029,,Completed,,-565.0,13.0
SIO5OMYPT1,2024-09-24 13:09:00.029,of Credit Party,Completed,442.61,,578.0
SIO5OMHESF,2024-09-24 13:05:00.010,,Completed,,-7.0,135.39
SIO5OMHESF,2024-09-24 13:05:00.010,,Completed,,-340.0,142.39
SIO4OLQNGE,2024-09-24 12:58:59.981,,Completed,,-7.0,482.39
SIO4OLQNGE,2024-09-24 12:58:59.981,,Completed,,-250.0,489.39
SIO8OLLF3O,2024-09-24 12:58:00.019,,Completed,,-13.0,739.39
SIO8OLLF3O,2024-09-24 12:58:00.019,,Completed,,-710.0,752.39
SIO9OKSMAF,2024-09-24 12:51:59.990,,Completed,,-100.0,1462.39
SIO9OJGCI5,2024-09-24 12:42:00.029,,Completed,,-50.0,1562.39
SIO5NNJWHB,2024-09-24 08:10:59.981,,Completed,,-887.61,1612.39
SIO7NNJRXR,2024-09-24 08:10:59.981,,Completed,2500.0,,2500.0
SIN5L3ZS17,2024-09-23 15:15:00.029,,Completed,,-20.0,0.0
SIN5L3ZS17,2024-09-23 15:15:00.029,of Credit Party,Completed,20.0,,20.0
SIL2CKPCGW,2024-09-21 11:39:00.029,,Completed,,-200.0,0.0
SIL2CKPCGW,2024-09-21 11:39:00.029,of Credit Party,Completed,200.0,,200.0
SIK5ASBJ2F,2024-09-20 20:03:00.029,,Completed,,-20.0,0.0
SIK5ASBJ2F,2024-09-20 20:03:00.029,of Credit Party,Completed,20.0,,20.0
SIK3AQLDX5,2024-09-20 19:54:00.029,,Completed,,-420.0,0.0
SIK3AQLDX5,2024-09-20 19:54:00.029,of Credit Party,Completed,420.0,,420.0
SIK5AOQDZH,2024-09-20 19:45:00.029,,Completed,,-2721.0,0.0
SIK5AOQDZH,2024-09-20 19:45:00.029,of Credit Party,Completed,212.88,,2721.0
SIK6AO5IFE,2024-09-20 19:43:00.019,,Completed,2325.0,,2508.12
SIK69AB2Q8,2024-09-20 14:55:00.019,,Completed,,-23.0,183.12
SIK69AB2Q8,2024-09-20 14:55:00.019,,Completed,,-1300.0,206.12
SIK68DOEBQ,2024-09-20 10:48:00.000,,Completed,,-50.0,1506.12
SIK68COW9G,2024-09-20 10:39:59.962,,Completed,,-1000.0,1556.12
SIH6XEVMH4,2024-09-17 19:02:00.038,,Completed,1500.0,,2556.12
SIH4WDQF0I,2024-09-17 15:20:59.971,,Completed,,-42.0,1056.12
SIH4WDQF0I,2024-09-17 15:20:59.971,,Completed,,-7000.0,1098.12
SIH7WDFJ1H,2024-09-17 15:18:59.962,,Completed,,-901.88,8098.12
SIH8WDFGT8,2024-09-17 15:18:59.962,,Completed,9000.0,,9000.0
SIG5RN9J75,2024-09-16 12:02:00.010,,Completed,,-13.0,0.0
SIG5RN9J75,2024-09-16 12:02:00.010,,Completed,,-755.0,13.0
SIG5RN9J75,2024-09-16 12:02:00.010,of Credit Party,Completed,768.0,,768.0
SIF0PT393G,2024-09-15 20:03:59.990,,Completed,,-200.0,0.0
SIF0PT393G,2024-09-15 20:03:59.990,of Credit Party,Completed,124.95,,200.0
SIF5OPY4ZD,2024-09-15 16:20:00.038,,Completed,,-924.95,75.05
SIF5OPY7WN,2024-09-15 16:20:00.038,,Completed,1000.0,,1000.0
SIF2OPTVKS,2024-09-15 16:18:59.990,,Completed,,-33.0,0.0
SIF2OPTVKS,2024-09-15 16:18:59.990,,Completed,,-1850.0,33.0
SIF2OPTVKS,2024-09-15 16:18:59.990,of Credit Party,Completed,915.79,,1883.0
SIF4NTC7KS,2024-09-15 12:20:00.010,,Completed,,-23.0,967.21
SIF4NTC7KS,2024-09-15 12:20:00.010,,Completed,,-1030.0,990.21
SIF7NT8223,2024-09-15 12:18:59.962,,Completed,,-279.79,2020.21
SIF1NT85QF,2024-09-15 12:18:59.962,,Completed,2300.0,,2300.0
SIE3M3F7T7,2024-09-14 20:37:59.981,,Completed,,-30.0,0.0
SIE3M3F7T7,2024-09-14 20:37:59.981,of Credit Party,Completed,30.0,,30.0
SIE1M396TR,2024-09-14 20:37:00.019,,Completed,,-20.0,0.0
SIE1M396TR,2024-09-14 20:37:00.019,of Credit Party,Completed,20.0,,20.0
SIE4M229CW,2024-09-14 20:30:59.990,,Completed,,-500.0,0.0
SIE4M229CW,2024-09-14 20:30:59.990,of Credit Party,Completed,227.01,,500.0
SID8GNLH1A,2024-09-13 16:45:00.029,,Completed,,-23.0,272.99
SID8GNLH1A,2024-09-13 16:45:00.029,,Completed,,-1200.0,295.99
SID0GGHX9Y,2024-09-13 15:54:59.962,,Completed,,-57.0,1495.99
SID0GGHX9Y,2024-09-13 15:54:59.962,,Completed,,-12300.0,1552.99
SID8GGE3SG,2024-09-13 15:54:00.000,,Completed,13000.0,,13852.99
SID0G9O98Y,2024-09-13 15:04:59.981,,Completed,,-70.0,852.99
SID5G4QAPJ,2024-09-13 14:28:59.981,OD Loan Repayment to 232323 - M-PESA Overdraw,Completed,,-47.01,922.99
SID3G4QDJP,2024-09-13 14:28:59.981,Transfer from Bank 517819 - IM BANK LIMITED- APP to Customer via API,Completed,970.0,,970.0
SID4FZLILO,2024-09-13 13:52:00.019,Merchant Payment Fuliza M-Pesa Online to 191388 - BEATUS PLACE 4,Completed,,-280.0,0.0
SID4FZLILO,2024-09-13 13:52:00.019,OverDraft of Credit Party,Completed,46.54,,280.0
SID5FP0Y47,2024-09-13 12:36:00.000,Airtime Purchase,Completed,,-50.0,233.46
SID8FH9IZO,2024-09-13 11:37:00.019,Pay Bill Charge,Completed,,-10.0,283.46
SID8FH9IZO,2024-09-13 11:37:00.019,Pay Bill Online to 247247 - Equity Paybill Account Acc. 0718433449,Completed,,-960.0,293.46
SID7FH4NML,2024-09-13 11:35:59.971,Transfer from Bank 517819 - IM BANK LIMITED- APP to Customer via API,Completed,1000.0,,1253.46
SID6FBA19U,2024-09-13 10:50:59.971,Pay Bill Online to 542542 - IM BANK C2B Acc. 786253,Completed,,-50.0,253.46
SIC8DX4UGW,2024-09-12 20:51:00.000,Transfer from Bank 517819 - IM BANK LIMITED- APP to Customer via API,Completed,1700.0,,1700.0
SIC3DX54WL,2024-09-12 20:51:00.000,OD Loan Repayment to 232323 - M-PESA Overdraw,Completed,,-1396.54,303.46
SIC1DWXAIZ,2024-09-12 20:50:00.038,Merchant Payment Fuliza M-Pesa Online to 7733814 - JOARK SPA VIA COOP,Completed,,-1500.0,0.0
SIC1DWXAIZ,2024-09-12 20:50:00.038,OverDraft of Credit Party,Completed,1382.71,,1500.0
SIC4D0EYVM,2024-09-12 18:11:59.971,Customer Transfer to - 2547******692 Charles Maina,Completed,,-50.0,117.29
SI981FQXNU,2024-09-09 19:54:59.990,Merchant Payment Online to 5119190 - RONGAI FRESHFINDS STORE LIMITED,Completed,,-430.0,167.29
SI94ZH2R3U,2024-09-09 17:01:59.981,Customer Transfer to - 2547******136 JOHN KAIRU,Completed,,-90.0,597.29
SI93Y7IZ6X,2024-09-09 11:37:00.019,Merchant Payment Online to 7188373 - PURE FRESH RONGAI STIMVAK,Completed,,-200.0,687.29
SI94Y754KO,2024-09-09 11:33:59.962,OD Loan Repayment to 232323 - M-PESA Overdraw,Completed,,-12.71,887.29
SI96Y757EO,2024-09-09 11:33:59.962,Transfer from Bank 517819 - IM BANK LIMITED- APP to Customer via API,Completed,900.0,,900.0
SI79RQAYO3,2024-09-07 17:48:59.990,"Merchant Payment Fuliza M-Pesa Online to 6809535 -
DIASPORUM KITCHEN",Completed,,-320.0,0.0
SI79RQAYO3,2024-09-07 17:48:59.990,OverDraft of Credit Party,Completed,12.58,,320.0
SI70RPDUAK,2024-09-07 17:44:00.010,Merchant Payment Online to 110174 - Quick Mart Rongai Express,Completed,,-450.0,307.42
SI70RON0M4,2024-09-07 17:39:59.990,OD Loan Repayment to 232323 - M-PESA Overdraw,Completed,,-242.58,757.42
SI79RON2RB,2024-09-07 17:39:59.990,Transfer from Bank 517819 - IM BANK LIMITED- APP to Customer via API,Completed,1000.0,,1000.0
SI70RMYWQO,2024-09-07 17:30:00.029,Customer Transfer of Funds Charge,Completed,,-7.0,0.0
SI70RMYWQO,2024-09-07 17:30:00.029,Customer Transfer Fuliza MPesa to - 2547******595 SARAH MURIGI,Completed,,-200.0,7.0
SI70RMYWQO,2024-09-07 17:30:00.029,OverDraft of Credit Party,Completed,207.0,,207.0
SI77RMMD7V,2024-09-07 17:28:00.019,Customer Transfer of Funds Charge,Completed,,-7.0,0.0
SI77RMMD7V,2024-09-07 17:28:00.019,Customer Transfer Fuliza MPesa to - 07******636 MILKA NYAKWEBA,Completed,,-360.0,7.0
SI77RMMD7V,2024-09-07 17:28:00.019,OverDraft of Credit Party,Completed,33.17,,367.0
SI71RLN3W5,2024-09-07 17:21:59.990,Customer Transfer of Funds Charge,Completed,,-7.0,333.83
SI71RLN3W5,2024-09-07 17:21:59.990,Customer Transfer to - 2547******315 FRANCIS MWANGI,Completed,,-335.0,340.83
SI72RKZ9D8,2024-09-07 17:17:59.971,Customer Transfer to - 2547******121 PETER MWANGI,Completed,,-100.0,675.83
SI76RJCPQM,2024-09-07 17:08:00.010,Merchant Payment Online to 7649353 - PICK UP MTAANI KENYA LTD,Completed,,-120.0,775.83
SI68ODZAM4,2024-09-06 20:10:59.981,Pay Bill Charge,Completed,,-10.0,895.83
SI68ODZAM4,2024-09-06 20:10:59.981,Pay Bill Online to 888880 - KPLC PREPAID Acc. 14467012614,Completed,,-1000.0,905.83
SI66N2RZFE,2024-09-06 16:07:00.019,Transfer from Bank 517819 - IM BANK LIMITED- APP to Customer via API,Completed,2000.0,,2000.0
SI67N2SBA3,2024-09-06 16:07:00.019,OD Loan Repayment to 232323 - M-PESA Overdraw,Completed,,-94.17,1905.83
SI55JYTRPL,2024-09-05 19:25:00.019,Customer Transfer Fuliza MPesa to - 2547******099 joy joy,Completed,,-50.0,0.0
SI55JYTRPL,2024-09-05 19:25:00.019,OverDraft of Credit Party,Completed,50.0,,50.0
SI51J1ZGXH,2024-09-05 16:32:00.010,Customer Transfer of Funds Charge,Completed,,-57.0,0.0
SI51J1ZGXH,2024-09-05 16:32:00.010,Customer Transfer Fuliza MPesa to - 2547******774 Kyalo Solomon,Completed,,-5000.0,57.0
SI51J1ZGXH,2024-09-05 16:32:00.010,OverDraft of Credit Party,Completed,43.23,,5057.0
SI52J1QIMG,2024-09-05 16:30:00.000,Pay Bill Online to 247247 - Equity Paybill Account Acc. 1260184676906,Completed,,-10.0,5013.77
SI50J1GQVW,2024-09-05 16:29:00.038,Pay Bill Charge,Completed,,-34.0,5023.77
SI50J1GQVW,2024-09-05 16:29:00.038,Pay Bill Online to 850436 - HAZINA SACCO LTD Acc. 37325314DEP,Completed,,-5000.0,5057.77
SI51J1CJ8R,2024-09-05 16:27:59.990,Pay Bill Charge,Completed,,-16.0,10057.77
SI51J1CJ8R,2024-09-05 16:27:59.990,Pay Bill Online to 505000 - OLD MUTUAL LIFE ASSURANCE KENYA LIMITED. Acc. OMU000329285,Completed,,-5000.0,10073.77
SI59J1AK09,2024-09-05 16:27:00.029,Pay Bill Charge,Completed,,-34.0,15073.77
SI59J1AK09,2024-09-05 16:27:00.029,Pay Bill Online to 850436 - HAZINA SACCO LTD Acc. 33826744DEP,Completed,,-5000.0,15107.77
SI58J17PY2,2024-09-05 16:27:00.029,Pay Bill Charge,Completed,,-34.0,20107.77
SI58J17PY2,2024-09-05 16:27:00.029,Pay Bill Online to 247247 - Equity Paybill Account Acc. 1260184676906,Completed,,-5000.0,20141.77
SI52J0Y1PS,2024-09-05 16:25:00.019,Pay Bill Charge,Completed,,-42.0,25141.77
SI52J0Y1PS,2024-09-05 16:25:00.019,Pay Bill Online to 247247 - Equity Paybill Account Acc. 0510173643067,Completed,,-6000.0,25183.77
SI56J0FVVA,2024-09-05 16:21:59.962,OD Loan Repayment to 232323 - M-PESA Overdraw,Completed,,-30.23,31183.77
SI57J0FYTF,2024-09-05 16:21:59.962,Transfer from Bank 517819 - IM BANK LIMITED- APP to Customer via API,Completed,30000.0,,31214.0
SI51IUNZE1,2024-09-05 15:40:59.981,Customer Transfer of Funds Charge,Completed,,-13.0,1214.0
SI51IUNZE1,2024-09-05 15:40:59.981,Customer Transfer to - 2547******254 MATHIAS MUTUA,Completed,,-1000.0,1227.0
SI40E3TDV0,2024-09-04 12:53:00.038,Merchant Payment Online to 7605335 - VICTORY FARMS - RONGAI,Completed,,-673.0,2327.0
SI40E2ER2G,2024-09-04 12:42:00.029,Customer Transfer of Funds Charge,Completed,,-13.0,3000.0
SI40E2ER2G,2024-09-04 12:42:00.029,Customer Transfer Fuliza MPesa to - 2547******743 DENNIS WAMURANGA,Completed,,-830.0,3013.0
SI40E2ER2G,2024-09-04 12:42:00.029,OverDraft of Credit Party,Completed,29.93,,3843.0
SI49E2EJYL,2024-09-04 12:42:00.029,Funds received from - 2547******326 OMONDI LOVELL,Completed,3000.0,,3813.07
SI287GVL4Y,2024-09-02 18:56:59.971,Merchant Payment Online to 7188373 - PURE FRESH RONGAI STIMVAK,Completed,,-200.0,813.07
SI246PIS0M,2024-09-02 16:23:00.010,Customer Transfer of Funds Charge,Completed,,-23.0,1013.07
SI246PIS0M,2024-09-02 16:23:00.010,Customer Transfer to - 01******452 NAncy okoth,Completed,,-1300.0,1036.07
SI192B5E9X,2024-09-01 14:30:00.029,Merchant Payment Online to 7099197 - CENTURY CINEMAX LTD SARIT,Completed,,-120.0,2336.07
SHV5WHFDWV,2024-08-31 11:12:59.990,Pay Bill Charge,Completed,,-20.0,2456.07
SHV5WHFDWV,2024-08-31 11:12:59.990,Pay Bill Online to 400200 - Co- operative Bank Money Transfer Acc. 01116572103600,Completed,,-2500.0,2476.07
SHV5WFXUJB,2024-08-31 11:01:00.019,OD Loan Repayment to 232323 - M-PESA Overdraw,Completed,,-23.93,4976.07
SHV3WFXUIP,2024-08-31 11:01:00.019,Salary Payment from 504900 - NCBA BANK via API. Original conversation ID is FTC240831KTUH.,Completed,5000.0,,5000.0
SHU6TENUD2,2024-08-30 15:56:59.971,Merchant Payment Fuliza M-Pesa Online to 7940890 -         LESS FORTUNATE,Completed,,-200.0,0.0
SHU6TENUD2,2024-08-30 15:56:59.971,OverDraft of Credit Party,Completed,23.69,,200.0
SHU7TEHX8L,2024-08-30 15:56:00.010,Merchant Payment Online to 491847 -            JANDEE GENERAL STORES,Completed,,-50.0,176.31
SHT6P062XK,2024-08-29 00:00:00.000,,Completed,,-470.0,226.31
SHT0OZQ3W0,2024-08-29 00:00:00.000,,Completed,,-303.69,696.31
SHT4OZQ6R6,2024-08-29 00:00:00.000,,Completed,1000.0,,1000.0
SHR0HBP1QK,2024-08-27 00:00:00.000,,Completed,,-260.0,0.0
SHR0HBP1QK,2024-08-27 00:00:00.000,of Credit,Completed,260.0,,260.0
SHR5HAJIWJ,2024-08-27 00:00:00.000,,Completed,,-7.0,0.0
SHR5HAJIWJ,2024-08-27 00:00:00.000,,Completed,,-200.0,7.0
SHR5HAJIWJ,2024-08-27 00:00:00.000,of Credit,Completed,40.68,,207.0
SHR2HAEFS8,2024-08-27 00:00:00.000,,Completed,,-60.0,166.32
SHR2H9SKAS,2024-08-27 00:00:00.000,,Completed,,-7.0,226.32
SHR2H9SKAS,2024-08-27 00:00:00.000,,Completed,,-260.0,233.32
SHR3H9I9S7,2024-08-27 00:00:00.000,,Completed,,-7.0,493.32
SHR3H9I9S7,2024-08-27 00:00:00.000,,Completed,,-360.0,500.32
SHR8H909KI,2024-08-27 00:00:00.000,,Completed,,-7.0,860.32
SHR8H909KI,2024-08-27 00:00:00.000,,Completed,,-280.0,867.32
SHR8H8HWQS,2024-08-27 00:00:00.000,,Completed,,-100.0,1147.32
SHR2H807VE,2024-08-27 00:00:00.000,,Completed,,-50.0,1247.32
SHR6H7FCP0,2024-08-27 00:00:00.000,,Completed,,-100.0,1297.32
SHR9GU8Q95,2024-08-27 00:00:00.000,,Completed,,-7.0,1397.32
SHR9GU8Q95,2024-08-27 00:00:00.000,,Completed,,-320.0,1404.32
SHR4GLAPU2,2024-08-27 00:00:00.000,,Completed,,-48.0,1724.32
SHR4GLAPU2,2024-08-27 00:00:00.000,,Completed,,-10000.0,1772.32
SHR1GL5CNT,2024-08-27 00:00:00.000,,Completed,10000.0,,11772.32
SHQ4BXCB70,2024-08-26 00:00:00.000,,Completed,,-1000.0,1772.32
SHQ6BR7N9Y,2024-08-26 00:00:00.000,,Completed,,-5.0,2772.32
SHQ6BR7N9Y,2024-08-26 00:00:00.000,,Completed,,-300.0,2777.32
SHP0AC1JDK,2024-08-25 00:00:00.000,,Completed,,-20.0,3077.32
SHP0AC1JDK,2024-08-25 00:00:00.000,,Completed,,-2450.0,3097.32
SHP2ABQDIE,2024-08-25 00:00:00.000,,Completed,5000.0,,5547.32
SHO640908A,2024-08-24 00:00:00.000,,Completed,,-520.0,547.32
SHN4311R8Y,2024-08-23 00:00:00.000,,Completed,,-831.0,1067.32
SHN12WFCPF,2024-08-23 00:00:00.000,,Completed,,-50.0,1898.32
SHN82MMWVY,2024-08-23 00:00:00.000,,Completed,,-140.0,1948.32
SHN32M3IXZ,2024-08-23 00:00:00.000,,Completed,2000.0,,2088.32
SHN723N149,2024-08-23 00:00:00.000,,Completed,,-120.0,88.32
SHM9WSMI4P,2024-08-22 00:00:00.000,,Completed,,-7.0,208.32
SHM9WSMI4P,2024-08-22 16:20:00.038,Customer Transfer to - 2547******309 GEORGE NJOROGE,Completed,,-305.0,215.32
SHM9WS9ZG9,2024-08-22 16:16:59.981,Customer Transfer of Funds Charge,Completed,,-7.0,520.32
SHM9WS9ZG9,2024-08-22 16:16:59.981,Customer Transfer to - 2547******565 EUCABETH NYAKWEBA,Completed,,-390.0,527.32
SHM5WPD68B,2024-08-22 15:54:00.000,Merchant Payment Online to 914213 - STAREHE BUTCHERY RONGAI 7,Completed,,-650.0,917.32
SHM2WPA0XC,2024-08-22 15:53:00.038,Transfer from Bank 517819 - IM BANK LIMITED- APP to Customer via API,Completed,1380.0,,1567.32
SHM0WO4HV2,2024-08-22 15:44:00.038,Merchant Payment Online to 491847 -            JANDEE GENERAL STORES,Completed,,-50.0,187.32
SHL1UFGKCD,2024-08-21 21:09:59.962,Pay Bill Charge,Completed,,-10.0,237.32
SHL1UFGKCD,2024-08-21 21:09:59.962,Pay Bill Online to 888880 - KPLC PREPAID Acc. 14467012614,Completed,,-1000.0,247.32
SHL9UFE0C3,2024-08-21 21:09:59.962,Transfer from Bank 517819 - IM BANK LIMITED- APP to Customer via API,Completed,1000.0,,1247.32
SHL6SCG5Q4,2024-08-21 13:21:00.000,Merchant Payment Online to 7380738 - KFC RONGAI - DINE IN,Completed,,-2040.0,247.32
SHL1SCCVV7,2024-08-21 13:20:00.038,Transfer from Bank 517819 - IM BANK LIMITED- APP to Customer via API,Completed,1000.0,,2287.32
SHL4SBY8R6,2024-08-21 13:16:59.981,Merchant Payment Online to 491847 -            JANDEE GENERAL STORES,Completed,,-50.0,1287.32
SHL6SBUHZ0,2024-08-21 13:16:00.019,Merchant Payment Online to 7527615 - Naivas Rongai,Completed,,-336.0,1337.32
SHL8S25YS6,2024-08-21 12:02:00.010,Merchant Payment Online to 838787 -  BANDARI BEAUTY,Completed,,-4000.0,1673.32
SHL8S0F5C8,2024-08-21 11:48:00.029,Transfer from Bank 517819 - IM BANK LIMITED- APP to Customer via API,Completed,4000.0,,5673.32
SHL0RUM074,2024-08-21 11:01:00.019,Airtime Purchase,Completed,,-100.0,1673.32
SHL0RR3ICI,2024-08-21 10:32:59.971,Transfer from Bank 517819 - IM BANK LIMITED- APP to Customer via API,Completed,1350.0,,1773.32
SHK6NQY5V2,2024-08-20 09:18:59.962,Airtime Purchase,Completed,,-20.0,423.32
SHJ3M8ZI37,2024-08-19 19:18:00.029,Merchant Payment Online to 110174 - Quick Mart Rongai Express,Completed,,-1155.0,443.32
SHJ4M4TVKS,2024-08-19 18:58:59.981,Customer Transfer to - 2547******309 GEORGE NJOROGE,Completed,,-20.0,1598.32
SHJ1M4QM07,2024-08-19 18:58:00.019,Customer Transfer of Funds Charge,Completed,,-7.0,1618.32
SHJ1M4QM07,2024-08-19 18:58:00.019,Customer Transfer to - 2547******309 GEORGE NJOROGE,Completed,,-105.0,1625.32
SHJ0M4IV00,2024-08-19 18:56:59.971,Customer Transfer of Funds Charge,Completed,,-7.0,1730.32
SHJ0M4IV00,2024-08-19 18:56:59.971,Customer Transfer to - 2547******750 LUCY GATHIMBA,Completed,,-180.0,1737.32
SHJ8M443OG,2024-08-19 18:54:59.962,Customer Transfer to - 2547******802 JANE KINYUA,Completed,,-100.0,1917.32
SHJ9M3J68V,2024-08-19 18:51:59.990,Transfer from Bank 517819 - IM BANK LIMITED- APP to Customer via API,Completed,2000.0,,2017.32
SHI5H8MUD5,2024-08-18 14:10:00.019,Pay Bill Charge,Completed,,-10.0,17.32
SHI5H8MUD5,2024-08-18 14:10:00.019,Pay Bill Online to 4156648 - MAGIC MOPERS LTD Acc. Magic,Completed,,-620.0,27.32
SHH8EQLVM4,2024-08-17 19:00:59.990,Customer Transfer to - 2547******442 JOHN MWANGI,Completed,,-70.0,647.32
SHH7EPB47V,2024-08-17 18:54:00.000,Merchant Payment Online to 110174 - Quick Mart Rongai Express,Completed,,-958.0,717.32
SHH2EMVAZU,2024-08-17 18:42:00.029,Merchant Payment Online to 7595779 - TIMOTHY MURIITHI KIBWI,Completed,,-120.0,1675.32
SHH8EL646M,2024-08-17 18:31:59.981,Customer Transfer of Funds Charge,Completed,,-7.0,1795.32
SHH8EL646M,2024-08-17 18:31:59.981,Customer Transfer to - 2547******565 EUCABETH NYAKWEBA,Completed,,-200.0,1802.32
SHH9EJP4GB,2024-08-17 18:24:00.029,Transfer from Bank 517819 - IM BANK LIMITED- APP to Customer via API,Completed,2000.0,,2002.32
SHG5BDLPEV,2024-08-16 20:57:00.029,Customer Transfer to - 2547******241 PAUL WAIGANJO,Completed,,-80.0,2.32
SHG8B8F96E,2024-08-16 00:00:00.000,,Completed,,-1730.0,82.32
SHG2B6D9EE,2024-08-16 00:00:00.000,,Completed,,-150.0,1812.32
SHG7B69B6J,2024-08-16 00:00:00.000,,Completed,2000.0,,2000.0
SHG1B69MZN,2024-08-16 00:00:00.000,,Completed,,-37.68,1962.32
SHG1B4DEDL,2024-08-16 00:00:00.000,,Completed,,-1750.0,0.0
SHG1B4DEDL,2024-08-16 00:00:00.000,of Credit,Completed,37.3,,1750.0
SHG5B28JZF,2024-08-16 00:00:00.000,,Completed,,-20.0,1712.7
SHG7B0NJR7,2024-08-16 00:00:00.000,,Completed,,-175.0,1732.7
SHF46NMXGE,2024-08-15 00:00:00.000,,Completed,,-200.0,1907.7
SHF55M8A6J,2024-08-15 00:00:00.000,,Completed,,-23.0,2107.7
SHF55M8A6J,2024-08-15 00:00:00.000,,Completed,,-1030.0,2130.7
SHE318HYG7,2024-08-14 00:00:00.000,,Completed,,-50.0,3160.7
SHD0Y97DRK,2024-08-13 00:00:00.000,,Completed,,-774.0,3210.7
SHD3Y6HGP5,2024-08-13 00:00:00.000,,Completed,,-50.0,3984.7
SHD5Y63KI9,2024-08-13 00:00:00.000,,Completed,,-40.0,4034.7
SHD2Y57POC,2024-08-13 00:00:00.000,,Completed,,-100.0,4074.7
SHD2Y4X4X4,2024-08-13 00:00:00.000,,Completed,,-7.0,4174.7
SHD2Y4X4X4,2024-08-13 00:00:00.000,,Completed,,-160.0,4181.7
SHD1Y3UR7Z,2024-08-13 00:00:00.000,,Completed,,-7.0,4341.7
SHD1Y3UR7Z,2024-08-13 00:00:00.000,,Completed,,-360.0,4348.7
SHD8Y1UORW,2024-08-13 00:00:00.000,,Completed,,-80.0,4708.7
SHD9Y06FBD,2024-08-13 00:00:00.000,,Completed,,-900.0,4788.7
SHD7XVLSMH,2024-08-13 00:00:00.000,,Completed,,-311.3,5688.7
SHD9XVLG0N,2024-08-13 00:00:00.000,,Completed,6000.0,,6000.0
SHB6NW5F3I,2024-08-11 00:00:00.000,,Completed,,-7.0,0.0
SHB6NW5F3I,2024-08-11 00:00:00.000,,Completed,,-200.0,7.0
SHB6NW5F3I,2024-08-11 00:00:00.000,of Credit,Completed,207.0,,207.0
SHB2NW50LQ,2024-08-11 00:00:00.000,,Completed,,-7.0,0.0
SHB2NW50LQ,2024-08-11 00:00:00.000,,Completed,,-200.0,7.0
SHB2NW50LQ,2024-08-11 00:00:00.000,of Credit,Completed,101.21,,207.0
SHB7NUO3ZR,2024-08-11 00:00:00.000,,Completed,,-50.0,105.79
SHB2NULPSK,2024-08-11 00:00:00.000,,Completed,,-100.0,155.79
SHA3LN5BK3,2024-08-10 00:00:00.000,,Completed,,-7.0,255.79
SHA3LN5BK3,2024-08-10 00:00:00.000,,Completed,,-500.0,262.79
SH94J8TLPM,2024-08-09 00:00:00.000,,Completed,,-23.0,762.79
SH94J8TLPM,2024-08-09 00:00:00.000,,Completed,,-1400.0,785.79
SH95HDH9I1,2024-08-09 00:00:00.000,,Completed,,-33.0,2185.79
SH95HDH9I1,2024-08-09 00:00:00.000,,Completed,,-2000.0,2218.79
SH90HCIRE2,2024-08-09 14:17:59.971,Customer Transfer to - 2547******555 JOYCE OWINO,Completed,,-20.0,4218.79
SH95HCEFPR,2024-08-09 14:17:00.010,Merchant Payment Online to 7605335 - VICTORY FARMS - RONGAI,Completed,,-668.0,4238.79
SH71BQ5N6Z,2024-08-07 22:20:00.038,Customer Transfer of Funds Charge,Completed,,-57.0,4906.79
SH71BQ5N6Z,2024-08-07 22:20:00.038,Customer Transfer to - 07******544 MARY NASIMIYU,Completed,,-5000.0,4963.79
SH78BPXOG4,2024-08-07 22:18:00.029,Salary Payment from 504900 - NCBA BANK via API. Original conversation ID is FTC240807LRWD.,Completed,10000.0,,10000.0
SH71BPXP6L,2024-08-07 22:18:00.029,OD Loan Repayment to 232323 - M-PESA Overdraw,Completed,,-36.21,9963.79
SH77B9SAD1,2024-08-07 20:24:59.962,Merchant Payment Fuliza M-Pesa Online to 7211925 - OPULENT ORCHARD,Completed,,-150.0,0.0
SH77B9SAD1,2024-08-07 20:24:59.962,OverDraft of Credit Party,Completed,35.85,,150.0
SH72B7VKKS,2024-08-07 20:15:00.000,OD Loan Repayment to 232323 - M-PESA Overdraw,Completed,,-485.85,114.15
SH70B7VKKG,2024-08-07 20:15:00.000,Transfer from Bank 517819 - IM BANK LIMITED- APP to Customer via API,Completed,600.0,,600.0
SH74B43UHE,2024-08-07 19:56:00.038,Merchant Payment Fuliza M-Pesa Online to 7188373 - PURE FRESH RONGAI STIMVAK,Completed,,-200.0,0.0
SH74B43UHE,2024-08-07 19:56:00.038,OverDraft of Credit Party,Completed,200.0,,200.0
SH543IKFSA,2024-08-05 21:24:59.990,Customer Transfer of Funds Charge,Completed,,-7.0,0.0
SH543IKFSA,2024-08-05 21:24:59.990,Customer Send Money to Micro SME Business  with Fuliza MPesa to - 2547******128 ALFRED ANZEYULA,Completed,,-400.0,7.0
SH543IKFSA,2024-08-05 21:24:59.990,OverDraft of Credit Party,Completed,281.03,,407.0
SH48WZCY2I,2024-08-04 16:02:00.038,Airtime Purchase,Completed,,-20.0,125.97
SH30U42F1I,2024-08-03 19:30:00.000,Customer Payment to Small Business to - 07******156 david mbatia,Completed,,-100.0,145.97
SH30TYAMJQ,2024-08-03 19:03:59.962,Pay Bill Online to 222111 - Family Bank Pesa Pap Acc. 531282,Completed,,-100.0,245.97
SH34TY6SES,2024-08-03 19:03:59.962,OD Loan Repayment to 232323 - M-PESA Overdraw,Completed,,-454.03,345.97
SH32TY6IXW,2024-08-03 19:03:00.000,Transfer from Bank 517819 - IM BANK LIMITED- APP to Customer via API,Completed,800.0,,800.0
SH32TAD3IE,2024-08-03 16:54:00.029,Customer Transfer of Funds Charge,Completed,,-23.0,0.0
SH32TAD3IE,2024-08-03 16:54:00.029,Customer Send Money to Micro SME Business  with Fuliza MPesa to - 2547******561 ROBERT BIRGEN,Completed,,-1080.0,23.0
SH32TAD3IE,2024-08-03 16:54:00.029,OverDraft of Credit Party,Completed,449.53,,1103.0
SH30STGP6Q,2024-08-03 14:57:00.029,Customer Transfer of Funds Charge,Completed,,-13.0,653.47
SH30STGP6Q,2024-08-03 14:57:00.029,Customer Transfer to - 07******716 FRANKLINE ANGUCHE,Completed,,-800.0,666.47
SH24QLATQW,2024-08-02 21:33:00.029,Merchant Payment Online to 6853317 -            JABIR HASSAN AWADH,Completed,,-1050.0,1466.47
SH21Q4B13V,2024-08-02 19:54:00.029,"Merchant Payment Online to 752300 - BALTIC TEXTILE
TRADING LTD-  Masaai Rd",Completed,,-800.0,2516.47
SH27PMIKKH,2024-08-02 18:31:59.981,"Merchant Payment Online to 6425792 -                BRIMAR
WATER KIOSK 1",Completed,,-10.0,3316.47
SH24PHHBB8,2024-08-02 18:06:00.029,Transfer from Bank 517819 - IM BANK LIMITED- APP to Customer via API,Completed,3000.0,,3326.47
SH16MFZSP6,2024-08-01 21:31:00.019,Pay Bill Charge,Completed,,-34.0,326.47
SH16MFZSP6,2024-08-01 21:31:00.019,Pay Bill Online to 850436 - HAZINA SACCO LTD Acc. 37325314DEP,Completed,,-5000.0,360.47
SH11MFV977,2024-08-01 21:29:59.971,Pay Bill Charge,Completed,,-16.0,5360.47
SH11MFV977,2024-08-01 21:29:59.971,Pay Bill Online to 505000 - OLD MUTUAL LIFE ASSURANCE KENYA LIMITED. Acc. OMU000329285,Completed,,-5000.0,5376.47
SH12MFTTRK,2024-08-01 21:29:59.971,Pay Bill Charge,Completed,,-34.0,10376.47
SH12MFTTRK,2024-08-01 21:29:59.971,Pay Bill Online to 850436 - HAZINA SACCO LTD Acc. 33826744DEP,Completed,,-5000.0,10410.47
SH17MFNP4D,2024-08-01 21:27:59.962,,Completed,5700.0,,15410.47
SH10MECY8K,2024-08-01 21:18:59.962,,Completed,,-42.0,9710.47
SH10MECY8K,2024-08-01 21:18:59.962,,Completed,,-5010.0,9752.47
SH17ME7LXZ,2024-08-01 21:18:00.000,,Completed,,-34.0,14762.47
SH17ME7LXZ,2024-08-01 21:18:00.000,,Completed,,-5000.0,14796.47
SH13MDMLSR,2024-08-01 21:13:59.981,,Completed,,-203.53,19796.47
SH13MDMXLR,2024-08-01 21:13:59.981,,Completed,20000.0,,20000.0
SGV3GV1HGR,2024-07-31 16:41:00.010,,Completed,,-407.0,0.0
SGV3GV1HGR,2024-07-31 16:41:00.010,of Credit Party,Completed,201.51,,407.0
SGV2GSJ86U,2024-07-31 16:23:59.971,,Completed,,-13.0,205.49
SGV2GSJ86U,2024-07-31 16:23:59.971,,Completed,,-580.0,218.49
SGV8GRTW9A,2024-07-31 16:18:59.990,,Completed,,-600.0,798.49
SGV8GRRPP8,2024-07-31 16:18:59.990,,Completed,400.0,,1398.49
SGV2GROVE0,2024-07-31 16:18:00.029,,Completed,500.0,,998.49
SGV3GQLWAN,2024-07-31 16:09:59.990,,Completed,,-50.0,498.49
SGV3FVU8AJ,2024-07-31 12:24:00.029,,Completed,,-200.0,548.49
SGU6CXAZ7E,2024-07-30 16:41:00.010,,Completed,,-30.0,748.49
SGT5A3TEK9,2024-07-29 20:01:00.019,,Completed,,-13.0,778.49
SGT5A3TEK9,2024-07-29 20:01:00.019,,Completed,,-1000.0,791.49
SGT9A3MPWH,2024-07-29 19:59:59.971,,Completed,1000.0,,1791.49
SGP9T4YFDJ,2024-07-25 18:15:59.990,,Completed,,-1000.0,791.49
SGO1NK72R7,2024-07-24 09:45:00.000,,Completed,,-546.0,1791.49
SGN3M4O6ZH,2024-07-23 19:32:00.010,,Completed,,-100.0,2337.49
SGN7M3QW6N,2024-07-23 19:27:00.029,,Completed,,-300.0,2437.49
SGN0M244NU,2024-07-23 19:20:00.038,,Completed,,-60.0,2737.49
SGN8M1ITUI,2024-07-23 19:16:59.981,,Completed,,-100.0,2797.49
SGN7M1315F,2024-07-23 19:14:59.971,,Completed,,-1214.0,2897.49
SGN0M0OWK2,2024-07-23 19:12:59.962,,Completed,,-23.0,4111.49
SGN0M0OWK2,2024-07-23 19:12:59.962,,Completed,,-1030.0,4134.49
SGM9IW5DAV,2024-07-22 20:21:00.029,,Completed,,-7.0,5164.49
SGM9IW5DAV,2024-07-22 20:21:00.029,,Completed,,-150.0,5171.49
SGM4ITL70Y,2024-07-22 20:06:00.000,,Completed,,-7.0,5321.49
SGM4ITL70Y,2024-07-22 20:06:00.000,,Completed,,-150.0,5328.49
SGM4ISKP5S,2024-07-22 20:01:00.019,,Completed,,-7.0,5478.49
SGM4ISKP5S,2024-07-22 20:01:00.019,,Completed,,-440.0,5485.49
SGM2IRFZQ6,2024-07-22 00:00:00.000,Customer Transfer of Funds Charge,Completed,,-7.0,5925.49
SGM2IRFZQ6,2024-07-22 00:00:00.000,Customer Transfer to - 2547******315 FRANCIS MWANGI,Completed,,-195.0,5932.49
SGM0IQ661S,2024-07-22 00:00:00.000,Customer Transfer of Funds Charge,Completed,,-7.0,6127.49
SGM0IQ661S,2024-07-22 00:00:00.000,Customer Transfer to - 2547******121 PETER MWANGI,Completed,,-160.0,6134.49
SGM1IOLRE7,2024-07-22 00:00:00.000,Merchant Payment Online to 6809535 -    DIASPORUM KITCHEN,Completed,,-75.0,6294.49
SGM1INL3YR,2024-07-22 00:00:00.000,Merchant Payment Online to 986625 - STAREHE BUTCHERY RONGAI,Completed,,-10.0,6369.49
SGM4INBS6S,2024-07-22 00:00:00.000,Merchant Payment Online to 986625 - STAREHE BUTCHERY RONGAI,Completed,,-50.0,6379.49
SGM0IMMGQQ,2024-07-22 00:00:00.000,Merchant Payment Online to 914213 - STAREHE BUTCHERY RONGAI 7,Completed,,-800.0,6429.49
SGM4IL3GA6,2024-07-22 00:00:00.000,Merchant Payment Online to 6304886 - Opulent   orchard.,Completed,,-110.0,7229.49
SGM2IKCMZ0,2024-07-22 00:00:00.000,Customer Payment to Small Business to - 2547******881 JANE MUTURI,Completed,,-50.0,7339.49
SGM1IJTX93,2024-07-22 00:00:00.000,Merchant Payment Online to 110174 - Quick Mart Rongai Express,Completed,,-908.0,7389.49
SGL1D9T6BN,2024-07-21 00:00:00.000,Customer Transfer of Funds Charge,Completed,,-23.0,8297.49
SGL1D9T6BN,2024-07-21 00:00:00.000,Customer Transfer to - 2547******472 DORCAS NZILI,Completed,,-1030.0,8320.49
SGK4C237XC,2024-07-20 00:00:00.000,Customer Transfer of Funds Charge,Completed,,-23.0,9350.49
SGK4C237XC,2024-07-20 00:00:00.000,Customer Transfer to - 07******544 MARY NASIMIYU,Completed,,-1030.0,9373.49
SGK0C21NE8,2024-07-20 00:00:00.000,Customer Transfer of Funds Charge,Completed,,-33.0,10403.49
SGK0C21NE8,2024-07-20 00:00:00.000,Customer Transfer to - 2547******472 DORCAS NZILI,Completed,,-2059.0,10436.49
SGK6AFLNUM,2024-07-20 00:00:00.000,Merchant Payment Online to 491847 -            JANDEE GENERAL STORES,Completed,,-50.0,12495.49
SGK9ADS4FJ,2024-07-20 00:00:00.000,Merchant Payment Online to 783381 - Kiddie Kloset,Completed,,-599.0,12545.49
SGK2ACIOR6,2024-07-20 00:00:00.000,Merchant Payment Online to 7527615 - Naivas Rongai,Completed,,-913.0,13144.49
SGK3A8UPY1,2024-07-20 00:00:00.000,Transfer from Bank 517819 - IM BANK LIMITED- APP to Customer via API,Completed,7000.0,,14057.49
SGK1A6S0XT,2024-07-20 00:00:00.000,"Promotion Payment from 3033815 - LOOP B2C. via API.
Orginal conversation ID is TAM2024072000209790620012 UD1.",Completed,7000.0,,7057.49
SGI8217UJO,2024-07-18 00:00:00.000,Customer Transfer of Funds Charge,Completed,,-7.0,57.49
SGI8217UJO,2024-07-18 00:00:00.000,Customer Transfer to - 07******544 MARY NASIMIYU,Completed,,-229.0,64.49
SGH9Y46MRV,2024-07-17 00:00:00.000,Customer Transfer of Funds Charge,Completed,,-7.0,293.49
SGH9Y46MRV,2024-07-17 00:00:00.000,Customer Transfer to - 2547******743 DENNIS WAMURANGA,Completed,,-250.0,300.49
SGH9Y1ABHV,2024-07-17 00:00:00.000,Customer Transfer of Funds Charge,Completed,,-33.0,550.49
SGH9Y1ABHV,2024-07-17 00:00:00.000,Customer Transfer to - 07******762 HILLARY AMBOKO,Completed,,-1700.0,583.49
SGH1Y17NX3,2024-07-17 00:00:00.000,Transfer from Bank 517819 - IM BANK LIMITED- APP to Customer via API,Completed,2000.0,,2283.49
SGF1QXMJRJ,2024-07-15 00:00:00.000,Pay Bill Charge,Completed,,-67.0,283.49
SGF1QXMJRJ,2024-07-15 00:00:00.000,Pay Bill Online to 542542 - IM BANK C2B Acc. 01203742076150,Completed,,-25000.0,350.49
SGF7QWX60F,2024-07-15 00:00:00.000,Merchant Payment Online to 7188373 - PURE FRESH RONGAI STIMVAK,Completed,,-200.0,25350.49
SGF5PWRNJ9,2024-07-15 00:00:00.000,Merchant Payment Online to 178456 - QUICK MART RONGAI,Completed,,-830.0,25550.49
SGF3PVID3N,2024-07-15 00:00:00.000,Merchant Payment Online to 110174 - Quick Mart Rongai Express,Completed,,-649.0,26380.49
SGF9PUKHRP,2024-07-15 00:00:00.000,Merchant Payment Online to 5119190 - RONGAI FRESHFINDS STORE LIMITED,Completed,,-300.0,27029.49
SGF2PUIIRE,2024-07-15 00:00:00.000,,Completed,,-170.51,27329.49
SGF7PUIDMT,2024-07-15 00:00:00.000,,Completed,27500.0,,27500.0
SGE9O8YVW5,2024-07-14 00:00:00.000,,Completed,,-100.0,0.0
SGE9O8YVW5,2024-07-14 00:00:00.000,of Credit,Completed,100.0,,100.0
SGE8O8TTHG,2024-07-14 00:00:00.000,,Completed,,-7.0,0.0
SGE8O8TTHG,2024-07-14 00:00:00.000,,Completed,,-200.0,7.0
SGE8O8TTHG,2024-07-14 00:00:00.000,of Credit,Completed,68.82,,207.0
SGD0L73BVW,2024-07-13 00:00:00.000,,Completed,,-100.0,138.18
SGD2L4K7DW,2024-07-13 00:00:00.000,,Completed,,-6100.0,238.18
SGD6L122FA,2024-07-13 00:00:00.000,,Completed,2500.0,,6338.18
SGD8JQM0TW,2024-07-13 00:00:00.000,,Completed,,-210.0,3838.18
SGD2J4U6OY,2024-07-13 00:00:00.000,,Completed,,-50.0,4048.18
SGD5J4MI8J,2024-07-13 00:00:00.000,,Completed,,-439.0,4098.18
SGD9J4IPQ7,2024-07-13 00:00:00.000,,Completed,4000.0,,4537.18
SGC6GSJBZ2,2024-07-12 00:00:00.000,,Completed,,-10.0,537.18
SGC6GSJBZ2,2024-07-12 00:00:00.000,,Completed,,-1000.0,547.18
SGC9GSFG5J,2024-07-12 00:00:00.000,,Completed,1000.0,,1547.18
SGB7C4AL5Z,2024-07-11 00:00:00.000,,Completed,,-13.0,547.18
SGB7C4AL5Z,2024-07-11 00:00:00.000,,Completed,,-550.0,560.18
SGB6BSM2WQ,2024-07-11 00:00:00.000,,Completed,,-119.0,1110.18
SGB6BR9APY,2024-07-11 00:00:00.000,,Completed,1600.0,,1600.0
SGB1BR9BIP,2024-07-11 00:00:00.000,,Completed,,-370.82,1229.18
SGB7BR2E2B,2024-07-11 00:00:00.000,,Completed,,-7.0,0.0
SGB7BR2E2B,2024-07-11 00:00:00.000,,Completed,,-200.0,7.0
SGB7BR2E2B,2024-07-11 00:00:00.000,of Credit,Completed,207.0,,207.0
SGA29RP0BA,2024-07-10 00:00:00.000,,Completed,,-7.0,0.0
SGA29RP0BA,2024-07-10 00:00:00.000,,Completed,,-200.0,7.0
SGA29RP0BA,2024-07-10 00:00:00.000,of Credit,Completed,160.14,,207.0
SGA980UNG7,2024-07-10 00:00:00.000,,Completed,,-167.0,46.86
SGA980UNG7,2024-07-10 00:00:00.000,,Completed,,-12000.0,213.86
SGA580QQGJ,2024-07-10 00:00:00.000,,Completed,4000.0,,12213.86
SGA07W8JVS,2024-07-10 00:00:00.000,,Completed,,-25.0,8213.86
SGA07W8JVS,2024-07-10 00:00:00.000,,Completed,,-3500.0,8238.86
SGA27TR66W,2024-07-10 00:00:00.000,,Completed,,-7.0,11738.86
SGA27TR66W,2024-07-10 00:00:00.000,,Completed,,-150.0,11745.86
SGA97RHXT1,2024-07-10 00:00:00.000,,Completed,,-20.0,11895.86
SGA07QWBQI,2024-07-10 00:00:00.000,,Completed,,-590.0,11915.86
SGA276W93A,2024-07-10 00:00:00.000,,Completed,,-10000.0,12505.86
SGA973TAUP,2024-07-10 00:00:00.000,,Completed,,-20.0,22505.86
SGA973TAUP,2024-07-10 00:00:00.000,,Completed,,-2260.0,22525.86
SGA671Z5FI,2024-07-10 00:00:00.000,,Completed,,-29.0,24785.86
SGA671Z5FI,2024-07-10 00:00:00.000,,Completed,,-500.0,24814.86
SGA36J62OB,2024-07-10 07:52:59.981,Business Payment from 501901 - KCB 1 via API. Original conversation ID is INTERSWITCH_20044560405.,Completed,23950.0,,25314.86
SG925KUCOQ,2024-07-09 20:17:59.971,Customer Transfer to - 2547******099 joy joy,Completed,,-50.0,1364.86
SG945KKK8Q,2024-07-09 20:15:59.962,Customer Payment to Small Business to - 2547******881 JANE MUTURI,Completed,,-80.0,1414.86
SG964ZUPWK,2024-07-09 18:29:59.971,Customer Transfer of Funds Charge,Completed,,-7.0,1494.86
SG964ZUPWK,2024-07-09 18:29:59.971,Customer Transfer to - 2547******595 SARAH MURIGI,Completed,,-330.0,1501.86
SG904ZGHWQ,2024-07-09 18:27:59.962,Customer Transfer to - 07******601 James Ong'ayi,Completed,,-70.0,1831.86
SG904YX9XC,2024-07-09 18:24:59.990,Customer Transfer of Funds Charge,Completed,,-7.0,1901.86
SG904YX9XC,2024-07-09 18:24:59.990,Customer Transfer to - 2547******565 EUCABETH NYAKWEBA,Completed,,-430.0,1908.86
SG994XVDW1,2024-07-09 18:18:59.962,Customer Transfer of Funds Charge,Completed,,-7.0,2338.86
SG994XVDW1,2024-07-09 18:18:59.962,Customer Transfer to - 2547******315 FRANCIS MWANGI,Completed,,-305.0,2345.86
SG944TD4D6,2024-07-09 17:53:00.010,KCB M-PESA Withdraw,Completed,2000.0,,2650.86
SG9347Z8SB,2024-07-09 15:24:00.029,Airtime Purchase,Completed,,-20.0,650.86
SG89YW83ED,2024-07-08 13:27:00.029,Merchant Payment Online to 7188373 - PURE FRESH RONGAI STIMVAK,Completed,,-200.0,670.86
SG74X7NNEY,2024-07-07 21:35:00.038,Merchant Payment Online to 7056009 - MBUZI FOODS LIMITED,Completed,,-7490.0,870.86
SG70X7IN4K,2024-07-07 21:33:00.029,KCB M-PESA Withdraw,Completed,7400.0,,8360.86
SG60TCEO42,2024-07-06 20:24:59.962,Merchant Payment Online to 110174 - Quick Mart Rongai Express,Completed,,-140.0,960.86
SG68QVSIFK,2024-07-06 10:57:59.962,Merchant Payment Online to 6900165 -             ALONG MAGOK MAJOK DHOR,Completed,,-120.0,1100.86
SG63Q1MJ0F,2024-07-06 02:24:00.000,Customer Transfer of Funds Charge,Completed,,-7.0,1220.86
SG63Q1MJ0F,2024-07-06 02:24:00.000,Customer Transfer to - 2547******151 GERALD MUNGAI,Completed,,-250.0,1227.86
SG66Q1CXYU,2024-07-06 02:03:00.029,Customer Transfer of Funds Charge,Completed,,-7.0,1477.86
SG66Q1CXYU,2024-07-06 02:03:00.029,Customer Transfer to - 2547******224 Wiene Mokua,Completed,,-450.0,1484.86
SG68Q16PSW,2024-07-06 01:50:59.971,Merchant Payment Online to 6709588 - DELAQUA LIMITED 29,Completed,,-4600.0,1934.86
SG66Q0KT10,2024-07-06 01:12:00.000,KCB M-PESA Withdraw,Completed,3000.0,,6534.86
SG69Q0K8CN,2024-07-06 01:12:00.000,Customer Transfer of Funds Charge,Completed,,-33.0,3534.86
SG69Q0K8CN,2024-07-06 01:12:00.000,Customer Transfer to - 2547******830 GEORGE MAINA,Completed,,-2000.0,3567.86
SG50PXV20E,2024-07-05 23:37:59.981,Customer Transfer of Funds Charge,Completed,,-7.0,5567.86
SG50PXV20E,2024-07-05 23:37:59.981,Customer Transfer to - 2547******877 GEORGE SIMBII,Completed,,-200.0,5574.86
SG57PVLC3Z,2024-07-05 22:54:00.029,KCB M-PESA Deposit,Completed,,-43000.0,5774.86
SG58OQPF44,2024-07-05 18:40:00.019,Customer Transfer of Funds Charge,Completed,,-23.0,48774.86
SG58OQPF44,2024-07-05 18:40:00.019,Customer Transfer to - 2547******743 DENNIS WAMURANGA,Completed,,-1190.0,48797.86
SG50NEEBVW,2024-07-05 13:18:59.990,Pay Bill Charge,Completed,,-108.0,49987.86
SG50NEEBVW,2024-07-05 13:18:59.990,Pay Bill Online to 850436 - HAZINA SACCO LTD Acc. 37325314DEP,Completed,,-50000.0,50095.86
SG51NE4N6B,2024-07-05 13:16:59.981,Pay Bill Charge,Completed,,-24.0,100095.86
SG51NE4N6B,2024-07-05 13:16:59.981,Pay Bill Online to 505000 - OLD MUTUAL LIFE ASSURANCE KENYA LIMITED. Acc. OMU000329285,Completed,,-50000.0,100119.86
SG54NDRHGI,2024-07-05 13:14:00.010,Pay Bill Charge,Completed,,-108.0,150119.86
SG54NDRHGI,2024-07-05 13:14:00.010,Pay Bill Online to 850436 - HAZINA SACCO LTD Acc. 33826744DEP,Completed,,-50000.0,150227.86
SG48L6QGAO,2024-07-04 19:47:00.038,Merchant Payment Online to 6304886 - Opulent   orchard.,Completed,,-290.0,200227.86
SG49KJR69D,2024-07-04 17:51:59.962,Business Payment from 300600 - Equity Bulk Account via API. Original conversation ID is EQ720104744179.,Completed,60000.0,,200517.86
SG44KJMTZE,2024-07-04 17:51:00.000,Business Payment from 300600 - Equity Bulk Account via API. Original conversation ID is EQ720104697059.,Completed,140000.0,,140517.86
SG43KG5UVV,2024-07-04 17:30:59.990,Pay Bill Charge,Completed,,-42.0,517.86
SG43KG5UVV,2024-07-04 17:30:59.990,Pay Bill Online to 247247 - Equity Paybill Account Acc. 1260184676906,Completed,,-5010.0,559.86
SG43KFRUDX,2024-07-04 17:28:00.019,Transfer from Bank 517819 - IM BANK LIMITED- APP to Customer via API,Completed,5000.0,,5569.86
SG28DLPP9K,2024-07-02 20:10:00.019,Merchant Payment Online to 6235004 - NYANA EMPORIUM LIMITED5.,Completed,,-410.0,569.86
SG23BQPDHB,2024-07-02 12:35:00.038,Merchant Payment Online to 7188373 - PURE FRESH RONGAI STIMVAK,Completed,,-200.0,979.86
SG119RN6P1,2024-07-01 19:54:00.029,Customer Transfer to - 2547******595 SARAH MURIGI,Completed,,-100.0,1179.86
SG119R5NVV,2024-07-01 19:52:00.019,Pay Bill Charge,Completed,,-5.0,1279.86
SG119R5NVV,2024-07-01 19:52:00.019,Pay Bill Online to 522533 - Lipa na KCB Acc. 7828057,Completed,,-120.0,1284.86
SG189QPKSK,2024-07-01 19:50:00.010,Customer Transfer of Funds Charge,Completed,,-7.0,1404.86
SG189QPKSK,2024-07-01 19:50:00.010,Customer Transfer to - 2547******565 EUCABETH NYAKWEBA,Completed,,-320.0,1411.86
SG109PQJWE,2024-07-01 19:45:00.029,Customer Transfer of Funds Charge,Completed,,-7.0,1731.86
SG109PQJWE,2024-07-01 19:45:00.029,Customer Transfer to - 2547******315 FRANCIS MWANGI,Completed,,-435.0,1738.86
SG129O60G2,2024-07-01 19:38:00.038,Customer Transfer of Funds Charge,Completed,,-7.0,2173.86
SG129O60G2,2024-07-01 19:38:00.038,Customer Transfer to - 2547******121 PETER MWANGI,Completed,,-300.0,2180.86
SG149KZXUM,2024-07-01 19:23:59.971,Transfer from Bank 517819 - IM BANK LIMITED- APP to Customer via API,Completed,2000.0,,2480.86
SFT41XFK96,2024-06-29 19:07:00.019,Merchant Payment Online to 6304886 - Opulent   orchard.,Completed,,-590.0,480.86
SFT11W2ZFV,2024-06-29 19:00:59.990,Customer Transfer to - 2547******109 ELLY OMOLLO,Completed,,-50.0,1070.86
SFT71VLOOV,2024-06-29 18:58:59.981,Customer Transfer of Funds Charge,Completed,,-7.0,1120.86
SFT71VLOOV,2024-06-29 18:58:59.981,Customer Transfer to - 2547******064 Hannah waweru,Completed,,-120.0,1127.86
SFT91UWF29,2024-06-29 18:54:59.962,Merchant Payment Online to 7852870 - DAVID KANA KARANJA,Completed,,-80.0,1247.86
SFT11SWOP1,2024-06-29 18:45:59.962,Merchant Payment Online to 914213 - STAREHE BUTCHERY RONGAI 7,Completed,,-500.0,1327.86
SFT91OTT5L,2024-06-29 18:24:59.990,Customer Transfer of Funds Charge,Completed,,-7.0,1827.86
SFT91OTT5L,2024-06-29 18:24:59.990,Customer Transfer to - 2547******552 JOYCE MAINA,Completed,,-300.0,1834.86
SFT71N5ZS5,2024-06-29 18:15:59.990,Customer Transfer to - 2547******632 MARY MUTIE,Completed,,-40.0,2134.86
SFT21MA7NY,2024-06-29 18:11:00.010,Customer Transfer to - 2547******710 JAMES KAHIHU,Completed,,-30.0,2174.86
SFT41J04ZK,2024-06-29 17:51:59.962,Withdrawal Charge,Completed,,-29.0,2204.86
SFT41J04ZK,2024-06-29 17:51:59.962,Customer Withdrawal At Agent Till 707223 - Robby Kenya Wao Tech Shop Masai Mall Rongai Agg,Completed,,-2000.0,2233.86
SFT01IMMXO,2024-06-29 17:48:59.990,Transfer from Bank 517819 - IM BANK LIMITED- APP to Customer via API,Completed,647.0,,4233.86
SFT81IHDR2,2024-06-29 17:48:59.990,Transfer from Bank 517819 - IM BANK LIMITED- APP to Customer via API,Completed,628.0,,3586.86
SFT0YXFEOA,2024-06-29 10:54:00.029,Merchant Payment Online to 6900165 -             ALONG MAGOK MAJOK DHOR,Completed,,-65.0,2958.86
SFR3RPWD51,2024-06-27 12:04:59.981,Pay Bill Charge,Completed,,-48.0,3023.86
SFR3RPWD51,2024-06-27 12:04:59.981,Pay Bill Online to 542542 - IM BANK C2B Acc. 00304182876150,Completed,,-10000.0,3071.86
SFR6RPSTC0,2024-06-27 12:04:00.019,Pay Bill Charge,Completed,,-34.0,13071.86
SFR6RPSTC0,2024-06-27 12:04:00.019,Pay Bill Online to 850436 - HAZINA SACCO LTD Acc. 37325314DEP,Completed,,-5000.0,13105.86
SFR9RPN9MX,2024-06-27 12:02:59.971,Pay Bill Charge,Completed,,-18.0,18105.86
SFR9RPN9MX,2024-06-27 00:00:00.000,Pay Bill Online to 505000 - OLD MUTUAL LIFE ASSURANCE KENYA LIMITED. Acc. OMU000329285,Completed,,-10000.0,18123.86
SFR9RPKQRT,2024-06-27 00:00:00.000,Pay Bill Charge,Completed,,-34.0,28123.86
SFR9RPKQRT,2024-06-27 00:00:00.000,Pay Bill Online to 850436 - HAZINA SACCO LTD Acc. 33826744DEP,Completed,,-5000.0,28157.86
SFR5RPHM2R,2024-06-27 00:00:00.000,Pay Bill Charge,Completed,,-34.0,33157.86
SFR5RPHM2R,2024-06-27 00:00:00.000,Pay Bill Online to 247247 - Equity Paybill Account Acc. 0510173643067,Completed,,-5000.0,33191.86
SFR9RPCIS9,2024-06-27 00:00:00.000,Customer Transfer of Funds Charge,Completed,,-33.0,38191.86
SFR9RPCIS9,2024-06-27 00:00:00.000,Customer Transfer 07******544 MARY,Completed,,-2030.0,38224.86
SFR0RP96R6,2024-06-27 00:00:00.000,"Receive International Transfer From 573388 - MOBEX MONEY.
Original conversation ID is TPTW000096521123.",Completed,40066.0,,40254.86
SFP8M25VEO,2024-06-25 00:00:00.000,Pay Bill to 200200 - Safaricom Post Paid Acc. 0729920461,Completed,,-1000.0,188.86
SFP5LQ46SZ,2024-06-25 00:00:00.000,Funds received from - 2547******326 OMONDI LOVELL,Completed,600.0,,1188.86
SFP5KJV11X,2024-06-25 00:00:00.000,Merchant Payment Online to 5000448 - JOHN KARANJA WANG'OMBE,Completed,,-65.0,588.86
SFP5KIO8C3,2024-06-25 00:00:00.000,Merchant Payment Online to 6900165 -             ALONG MAGOK MAJOK DHOR,Completed,,-20.0,653.86
SFO4HMK8BQ,2024-06-24 00:00:00.000,Send Money Reversal via API to - 07******656 ALICE OWINO,Completed,,-240.0,673.86
SFO7HM0XV9,2024-06-24 00:00:00.000,Funds received from - 07******656 ALICE OWINO,Completed,240.0,,913.86
SFN2FH91ZU,2024-06-23 00:00:00.000,Merchant Payment Online to 110174 - Quick Mart Rongai Express,Completed,,-315.0,673.86
SFN6FG55S2,2024-06-23 00:00:00.000,Merchant Payment Online to 6304886 - Opulent   orchard.,Completed,,-260.0,988.86
SFN2FEUX14,2024-06-23 00:00:00.000,Customer Transfer of Funds Charge,Completed,,-7.0,1248.86
SFN2FEUX14,2024-06-23 00:00:00.000,Customer Transfer to - 2547******309 GEORGE NJOROGE,Completed,,-350.0,1255.86
SFN7FE332P,2024-06-23 00:00:00.000,Customer Transfer to - 2547******084 Bevin Juma,Completed,,-40.0,1605.86
SFN3FDHC0B,2024-06-23 00:00:00.000,Customer Transfer to - 2547******315 FRANCIS MWANGI,Completed,,-20.0,1645.86
SFN6FD9RJI,2024-06-23 00:00:00.000,Customer Transfer to - 2547******565 EUCABETH NYAKWEBA,Completed,,-80.0,1665.86
SFL98C5AGX,2024-06-21 00:00:00.000,Merchant Payment Online to 110174 - Quick Mart Rongai Express,Completed,,-598.0,1745.86
SFL28BF9V8,2024-06-21 00:00:00.000,Transfer from Bank 517819 - IM BANK LIMITED- APP to Customer via API,Completed,2000.0,,2343.86
SFK84XETU8,2024-06-20 00:00:00.000,Customer Transfer to - 2547******474 ANTONY RIUNGU,Completed,,-70.0,343.86
SFK94WFMH9,2024-06-20 00:00:00.000,Customer Payment to Small Business to - 2547******084 Bevin Juma,Completed,,-50.0,413.86
SFK14VWAZT,2024-06-20 00:00:00.000,Merchant Payment Online to 5000448 - JOHN KARANJA WANG'OMBE,Completed,,-300.0,463.86
SFK04V1J32,2024-06-20 00:00:00.000,Customer Transfer of Funds Charge,Completed,,-7.0,763.86
SFK04V1J32,2024-06-20 00:00:00.000,Customer Transfer to - 2547******595 SARAH MURIGI,Completed,,-160.0,770.86
SFK84UWQ3S,2024-06-20 00:00:00.000,Customer Transfer of Funds Charge,Completed,,-7.0,930.86
SFK84UWQ3S,2024-06-20 00:00:00.000,Customer Transfer to - 2547******315 FRANCIS MWANGI,Completed,,-280.0,937.86
SFK04TYXUU,2024-06-20 00:00:00.000,Customer Transfer of Funds Charge,Completed,,-7.0,1217.86
SFK04TYXUU,2024-06-20 00:00:00.000,Customer Transfer to - 2547******565 EUCABETH NYAKWEBA,Completed,,-330.0,1224.86
SFK64T41YO,2024-06-20 00:00:00.000,Customer Transfer of Funds Charge,Completed,,-7.0,1554.86
SFK64T41YO,2024-06-20 00:00:00.000,Customer Transfer to - 2547******121 PETER MWANGI,Completed,,-120.0,1561.86
SFK44RTJMS,2024-06-20 00:00:00.000,Customer Transfer of Funds Charge,Completed,,-7.0,1681.86
SFK44RTJMS,2024-06-20 20:01:00.019,Customer Transfer to - 2547******762 Daphine Moses,Completed,,-200.0,1688.86
SFK94RNZQ9,2024-06-20 20:01:00.019,Merchant Payment Online to 6809535 -    DIASPORUM KITCHEN,Completed,,-270.0,1888.86
SFK94QP02H,2024-06-20 19:56:00.038,Transfer from Bank 517819 - IM BANK LIMITED- APP to Customer via API,Completed,2000.0,,2158.86
SFK42VC9KA,2024-06-20 12:09:59.962,Merchant Payment Online to 7646741 - PABIROS COFFEE AND SNACKSHOP,Completed,,-1290.0,158.86
SFK32UDGZR,2024-06-20 12:00:59.962,Merchant Payment Online to 7646741 - PABIROS COFFEE AND SNACKSHOP,Completed,,-230.0,1448.86
SFJ8YPV3JQ,2024-06-19 14:21:00.029,Customer Transfer of Funds Charge,Completed,,-7.0,1678.86
SFJ8YPV3JQ,2024-06-19 14:21:00.029,Customer Transfer to - 2547******743 DENNIS WAMURANGA,Completed,,-220.0,1685.86
SFJ8YP8N3U,2024-06-19 14:15:59.962,OD Loan Repayment to 232323 - M-PESA Overdraw,Completed,,-94.14,1905.86
SFJ7YP8PBJ,2024-06-19 14:15:59.962,Transfer from Bank 517819 - IM BANK LIMITED- APP to Customer via API,Completed,2000.0,,2000.0
SFJ2YP2YFM,2024-06-19 14:15:00.000,Customer Transfer of Funds Charge,Completed,,-7.0,0.0
SFJ2YP2YFM,2024-06-19 14:15:00.000,Customer Transfer Fuliza MPesa to - 2547******743 DENNIS WAMURANGA,Completed,,-200.0,7.0
SFJ2YP2YFM,2024-06-19 14:15:00.000,OverDraft of Credit Party,Completed,93.2,,207.0
SFI2WJ321K,2024-06-18 19:59:00.010,Customer Transfer of Funds Charge,Completed,,-7.0,113.8
SFI2WJ321K,2024-06-18 19:59:00.010,Customer Payment to Small Business to - 2547******881 JANE MUTURI,Completed,,-110.0,120.8
SFH6TE6HZK,2024-06-17 21:58:59.981,Customer Transfer to - 2547******474 ANTONY RIUNGU,Completed,,-70.0,230.8
SFH8TDPTL6,2024-06-17 21:54:59.962,Customer Transfer of Funds Charge,Completed,,-33.0,300.8
SFH8TDPTL6,2024-06-17 21:54:59.962,Customer Transfer to - 2547******762 Daphine Moses,Completed,,-1900.0,333.8
SFH0RJ12QA,2024-06-17 14:23:00.038,Merchant Payment Online to 7605335 - VICTORY FARMS - RONGAI,Completed,,-709.0,2233.8
SFH4RCC8IC,2024-06-17 13:30:00.000,Transfer from Bank 517819 - IM BANK LIMITED- APP to Customer via API,Completed,3000.0,,3000.0
SFH6RCCBHW,2024-06-17 13:30:00.000,OD Loan Repayment to 232323 - M-PESA Overdraw,Completed,,-57.2,2942.8
SFH2RC7PJ2,2024-06-17 13:29:00.038,Merchant Payment Fuliza M-Pesa Online to 7654009 -    NIGEL OUKO,Completed,,-1700.0,0.0
SFH2RC7PJ2,2024-06-17 13:29:00.038,OverDraft of Credit Party,Completed,56.63,,1700.0
SFD0EUNS6E,2024-06-13 22:07:00.019,Pay Bill Charge,Completed,,-20.0,1643.37
SFD0EUNS6E,2024-06-13 22:07:00.019,Pay Bill Online to 714777 - LOOP C2B Acc. 440006569908,Completed,,-2500.0,1663.37
SFD4C8FTJG,2024-06-13 11:10:00.019,Merchant Payment Online to 110174 - Quick Mart Rongai Express,Completed,,-200.0,4163.37
SFD5C76L9F,2024-06-13 10:59:00.010,Customer Transfer of Funds Charge,Completed,,-7.0,4363.37
SFD5C76L9F,2024-06-13 10:59:00.010,Customer Transfer to - 2547******565 EUCABETH NYAKWEBA,Completed,,-220.0,4370.37
SFD7C4C0NB,2024-06-13 10:34:59.981,Pay Bill Charge,Completed,,-5.0,4590.37
SFD7C4C0NB,2024-06-13 10:34:59.981,Pay Bill Online to 522533 - Lipa na KCB Acc. 5842875,Completed,,-250.0,4595.37
SFD1C43MMD,2024-06-13 10:32:59.971,Pay Bill Charge,Completed,,-20.0,4845.37
SFD1C43MMD,2024-06-13 10:32:59.971,Pay Bill Online to 522533 - Lipa na KCB Acc. 5842875,Completed,,-1940.0,4865.37
SFD0C2BTKG,2024-06-13 10:18:59.990,Merchant Payment Online to 914213 - STAREHE BUTCHERY RONGAI 7,Completed,,-1300.0,6805.37
SFD7C0HV2F,2024-06-13 10:03:00.000,OD Loan Repayment to 232323 - M-PESA Overdraw,Completed,,-505.63,8105.37
SFD7C0HIO1,2024-06-13 10:03:00.000,"Receive International Transfer From 573388 - MOBEX MONEY.
Original conversation ID is TPTW000095252151.",Completed,8611.0,,8611.0
SF97YDCSUF,2024-06-09 19:27:59.990,Merchant Payment Fuliza M-Pesa Online to 110174 - Quick Mart Rongai Express,Completed,,-147.0,0.0
SF97YDCSUF,2024-06-09 19:27:59.990,OverDraft of Credit Party,Completed,147.0,,147.0
SF97YCLP3H,2024-06-09 19:23:59.971,,Completed,,-40.0,0.0
SF97YCLP3H,2024-06-09 19:23:59.971,of Credit Party,Completed,40.0,,40.0
SF90YA8LLG,2024-06-09 19:12:00.000,,Completed,,-4000.0,0.0
SF90YA8LLG,2024-06-09 19:12:00.000,of Credit Party,Completed,310.65,,4000.0
SF99Y9J1CJ,2024-06-09 19:07:59.981,,Completed,97.0,,3689.35
SF91Y8WYUN,2024-06-09 19:05:00.010,,Completed,2400.0,,3592.35
SF94XHQPLC,2024-06-09 16:07:59.981,,Completed,,-50.0,1192.35
SF90XHDTW6,2024-06-09 16:05:00.010,,Completed,,-399.0,1242.35
SF96XFO5WC,2024-06-09 15:51:00.029,,Completed,,-133.65,1641.35
SF97XFO2UX,2024-06-09 15:51:00.029,,Completed,1775.0,,1775.0
SF84U2AM3M,2024-06-08 16:56:00.038,,Completed,,-13.0,0.0
SF84U2AM3M,2024-06-08 16:56:00.038,,Completed,,-750.0,13.0
SF84U2AM3M,2024-06-08 16:56:00.038,of Credit Party,Completed,132.32,,763.0
SF83TZHU9X,2024-06-08 16:36:59.990,,Completed,1000.0,,1000.0
SF81TZI1S5,2024-06-08 16:36:59.990,,Completed,,-369.32,630.68
SF87TVTFAD,2024-06-08 16:11:00.038,,Completed,,-100.0,0.0
SF87TVTFAD,2024-06-08 16:11:00.038,of Credit Party,Completed,100.0,,100.0
SF85TT5ORL,2024-06-08 15:51:00.029,,Completed,,-13.0,0.0
SF85TT5ORL,2024-06-08 15:51:00.029,,Completed,,-1000.0,13.0
SF85TT5ORL,2024-06-08 15:51:00.029,of Credit Party,Completed,265.66,,1013.0
SF84TQRAMU,2024-06-08 15:33:59.990,,Completed,,-34.0,747.34
SF84TQRAMU,2024-06-08 15:33:59.990,,Completed,,-3800.0,781.34
SF80TFICTM,2024-06-08 14:10:00.019,,Completed,,-230.0,4581.34
SF84TF2P8K,2024-06-08 14:06:59.962,,Completed,,-10.0,4811.34
SF84TF2P8K,2024-06-08 14:06:59.962,,Completed,,-730.0,4821.34
SF85T8J8ER,2024-06-08 13:18:59.990,,Completed,5000.0,,5551.34
SF76POXEUK,2024-06-07 14:35:00.010,,Completed,,-200.0,551.34
SF75OQWKDF,2024-06-07 10:07:59.981,,Completed,,-300.0,751.34
SF78OQR9KM,2024-06-07 10:07:00.019,,Completed,,-100.0,1051.34
SF61MVOSO7,2024-06-06 18:45:59.962,,Completed,,-7.0,1151.34
SF61MVOSO7,2024-06-06 18:45:59.962,,Completed,,-250.0,1158.34
SF65MVGIZX,2024-06-06 18:45:00.000,,Completed,,-7.0,1408.34
SF65MVGIZX,2024-06-06 18:45:00.000,,Completed,,-260.0,1415.34
SF68MUYDZY,2024-06-06 18:42:59.990,,Completed,,-7.0,1675.34
SF68MUYDZY,2024-06-06 18:42:59.990,,Completed,,-465.0,1682.34
SF67MUMWLF,2024-06-06 18:40:59.981,,Completed,2000.0,,2147.34
SF60MT66Q6,2024-06-06 18:33:59.990,,Completed,,-7.0,147.34
SF60MT66Q6,2024-06-06 00:00:00.000,Customer Transfer to - 2547******121 PETER MWANGI,Completed,,-200.0,154.34
SF42FT4YLE,2024-06-04 00:00:00.000,Customer Transfer to - 2547******881 JANE MUTURI,Completed,,-40.0,354.34
SF42FSSFY2,2024-06-04 00:00:00.000,Customer Transfer to - 2547******756 SEBERINA LIICHA,Completed,,-70.0,394.34
SF45FSGBU5,2024-06-04 00:00:00.000,Customer Transfer of Funds Charge,Completed,,-7.0,464.34
SF45FSGBU5,2024-06-04 00:00:00.000,Customer Transfer to - 2547******802 JANE KINYUA,Completed,,-120.0,471.34
SF48F2YJWQ,2024-06-04 00:00:00.000,Pay Bill Charge,Completed,,-34.0,591.34
SF48F2YJWQ,2024-06-04 00:00:00.000,Pay Bill Online to 247247 - Equity Paybill Account Acc. 0510173643067,Completed,,-5000.0,625.34
